Posting_Date,Loan_No,Loan_Product_Type,Interest_Paid,Principle_Paid,Total_Paid
2025-02-20,A00109,INUKA6WKS,0,700,700
2025-02-25,A00337,INUKA6WKS,500,1167,1667
2025-02-26,A00103,BIASHARA4W,250,1250,1500
2025-02-26,A00109,INUKA6WKS,100,0,100
2025-02-26,A00148,BIASHARA6W,235,0,235
2025-02-26,A00150,BIASHARA6W,200,0,200
2025-02-27,A00104,BIASHARA4W,250,1250,1500
2025-02-27,A00108,BIASHARA4W,250,1250,1500
2025-02-27,A00109,INUKA6WKS,400,470,870
2025-02-27,A00117,BIASHARA6W,334,833,1167
2025-02-27,A00118,BIASHARA4W,250,1250,1500
2025-02-27,A00119,BIASHARA6W,334,466,800
2025-02-27,A00120,BIASHARA6W,334,833,1167
2025-02-27,A00148,BIASHARA6W,99,136,235
2025-02-27,A00164,INUKA 4WKS,500,200,700
2025-02-27,A00325,INUKA6WKS,500,1100,1600
2025-02-28,A00119,BIASHARA6W,0,367,367
2025-02-28,A00148,BIASHARA6W,0,235,235
2025-02-28,A00151,INUKA6WKS,500,0,500
2025-02-28,A00325,INUKA6WKS,0,70,70
2025-03-01,A00148,BIASHARA6W,0,235,235
2025-03-02,A00139,INUKA 4WKS,500,1750,2250
2025-03-02,A00140,INUKA6WKS,503,1167,1670
2025-03-02,A00141,BIASHARA6W,336,834,1170
2025-03-02,A00142,INUKA6WKS,503,1167,1670
2025-03-02,A00156,INUKA 4WKS,500,2000,2500
2025-03-03,A00148,BIASHARA6W,2,228,230
2025-03-03,A00149,INUKA6WKS,500,1140,1640
2025-03-03,A00336,INUKA6WKS,500,600,1100
2025-03-04,A00149,INUKA6WKS,0,30,30
2025-03-04,A00150,BIASHARA6W,134,833,967
2025-03-04,A00151,INUKA6WKS,3,1167,1170
2025-03-04,A00152,BIASHARA6W,334,833,1167
2025-03-04,A00336,INUKA6WKS,0,400,400
2025-03-05,A00103,BIASHARA4W,250,1250,1500
2025-03-05,A00109,INUKA6WKS,303,697,1000
2025-03-05,A00148,BIASHARA6W,235,0,235
2025-03-05,A00155,INUKA 4WKS,500,2000,2500
2025-03-05,A00165,INUKA 4WKS,550,1750,2300
2025-03-05,A00337,INUKA6WKS,500,680,1180
2025-03-06,A00108,BIASHARA4W,250,1250,1500
2025-03-06,A00109,INUKA6WKS,197,473,670
2025-03-06,A00117,BIASHARA6W,334,833,1167
2025-03-06,A00118,BIASHARA4W,250,1250,1500
2025-03-06,A00119,BIASHARA6W,334,833,1167
2025-03-06,A00148,BIASHARA6W,97,138,235
2025-03-06,A00172,BIASHARA4W,250,1250,1500
2025-03-06,A00173,BIASHARA4W,250,800,1050
2025-03-06,A00192,INUKA6WKS,280,0,280
2025-03-06,A00325,INUKA6WKS,503,1167,1670
2025-03-06,A00336,INUKA6WKS,500,200,700
2025-03-06,A00337,INUKA6WKS,3,487,490
2025-03-07,A00104,BIASHARA4W,250,1250,1500
2025-03-07,A00120,BIASHARA6W,334,833,1167
2025-03-07,A00163,INUKA 4WKS,500,1750,2250
2025-03-07,A00164,INUKA 4WKS,500,1750,2250
2025-03-07,A00170,INUKA6WKS,500,1100,1600
2025-03-07,A00173,BIASHARA4W,0,450,450
2025-03-07,A00192,INUKA6WKS,220,60,280
2025-03-07,A00199,BIASHARA6W,200,0,200
2025-03-07,A00336,INUKA6WKS,0,800,800
2025-03-08,A00148,BIASHARA6W,0,470,470
2025-03-08,A00171,INUKA6WKS,500,0,500
2025-03-08,A00199,BIASHARA6W,134,66,200
2025-03-08,A00202,BIASHARA6W,200,0,200
2025-03-09,A00139,INUKA 4WKS,500,1750,2250
2025-03-09,A00141,BIASHARA6W,332,168,500
2025-03-09,A00142,INUKA6WKS,503,1167,1670
2025-03-09,A00151,INUKA6WKS,170,0,170
2025-03-09,A00152,BIASHARA6W,334,833,1167
2025-03-09,A00170,INUKA6WKS,3,67,70
2025-03-09,A00178,INUKA 4WKS,500,1750,2250
2025-03-09,A00179,BIASHARA4W,250,1250,1500
2025-03-09,A00180,BIASHARA4W,250,1250,1500
2025-03-09,A00181,INUKA6WKS,500,500,1000
2025-03-09,A00199,BIASHARA6W,0,100,100
2025-03-10,A00140,INUKA6WKS,503,1167,1670
2025-03-10,A00141,BIASHARA6W,0,375,375
2025-03-10,A00148,BIASHARA6W,4,226,230
2025-03-10,A00151,INUKA6WKS,200,0,200
2025-03-10,A00181,INUKA6WKS,0,667,667
2025-03-10,A00183,INUKA6WKS,500,600,1100
2025-03-10,A00192,INUKA6WKS,0,400,400
2025-03-10,A00193,BIASHARA6W,334,66,400
2025-03-10,A00199,BIASHARA6W,0,100,100
2025-03-10,A00337,INUKA6WKS,497,503,1000
2025-03-11,A00149,INUKA6WKS,500,1170,1670
2025-03-11,A00151,INUKA6WKS,133,1167,1300
2025-03-11,A00183,INUKA6WKS,0,567,567
2025-03-11,A00194,BIASHARA6W,336,834,1170
2025-03-11,A00202,BIASHARA6W,134,166,300
2025-03-11,A00229,BIASHARA6W,200,0,200
2025-03-11,A00337,INUKA6WKS,0,400,400
2025-03-12,A00103,BIASHARA4W,250,1250,1500
2025-03-12,A00109,INUKA6WKS,106,694,800
2025-03-12,A00141,BIASHARA6W,4,291,295
2025-03-12,A00150,BIASHARA6W,334,366,700
2025-03-12,A00155,INUKA 4WKS,500,2000,2500
2025-03-12,A00156,INUKA 4WKS,500,2000,2500
2025-03-12,A00165,INUKA 4WKS,550,1750,2300
2025-03-12,A00190,INUKA 4WKS,500,1500,2000
2025-03-12,A00191,INUKA6WKS,500,1000,1500
2025-03-12,A00192,INUKA6WKS,280,707,987
2025-03-12,A00195,BIASHARA6W,334,833,1167
2025-03-12,A00199,BIASHARA6W,2,568,570
2025-03-12,A00229,BIASHARA6W,134,66,200
2025-03-12,A00337,INUKA6WKS,3,264,267
2025-03-13,A00104,BIASHARA4W,250,1250,1500
2025-03-13,A00109,INUKA6WKS,394,476,870
2025-03-13,A00117,BIASHARA6W,334,833,1167
2025-03-13,A00118,BIASHARA4W,250,1250,1500
2025-03-13,A00119,BIASHARA6W,334,66,400
2025-03-13,A00172,BIASHARA4W,250,1250,1500
2025-03-13,A00192,INUKA6WKS,220,60,280
2025-03-13,A00193,BIASHARA6W,12,768,780
2025-03-13,A00199,BIASHARA6W,170,0,170
2025-03-13,A00200,BIASHARA6W,334,833,1167
2025-03-13,A00207,INUKA6WKS,513,1167,1680
2025-03-13,A00208,BIASHARA4W,250,1250,1500
2025-03-13,A00229,BIASHARA6W,0,200,200
2025-03-13,A00325,INUKA6WKS,503,1167,1670
2025-03-13,A00336,INUKA6WKS,500,500,1000
2025-03-14,A00119,BIASHARA6W,0,767,767
2025-03-14,A00120,BIASHARA6W,334,833,1167
2025-03-14,A00164,INUKA 4WKS,0,1200,1200
2025-03-14,A00170,INUKA6WKS,497,403,900
2025-03-14,A00192,INUKA6WKS,0,200,200
2025-03-14,A00199,BIASHARA6W,100,0,100
2025-03-14,A00202,BIASHARA6W,0,337,337
2025-03-14,A00209,INUKA8WKS,515,875,1390
2025-03-14,A00210,BIASHARA6W,334,833,1167
2025-03-14,A00336,INUKA6WKS,0,500,500
2025-03-15,A00150,BIASHARA6W,0,200,200
2025-03-15,A00163,INUKA 4WKS,500,1750,2250
2025-03-15,A00164,INUKA 4WKS,400,350,750
2025-03-15,A00173,BIASHARA4W,250,1250,1500
2025-03-15,A00193,BIASHARA6W,250,0,250
2025-03-15,A00199,BIASHARA6W,62,38,100
2025-03-15,A00202,BIASHARA6W,0,210,210
2025-03-15,A00229,BIASHARA6W,0,400,400
2025-03-15,A00248,BIASHARA6W,200,0,200
2025-03-16,A00108,BIASHARA4W,250,450,700
2025-03-16,A00139,INUKA 4WKS,500,1750,2250
2025-03-16,A00141,BIASHARA6W,336,834,1170
2025-03-16,A00178,INUKA 4WKS,500,1750,2250
2025-03-16,A00179,BIASHARA4W,250,1250,1500
2025-03-16,A00181,INUKA6WKS,500,900,1400
2025-03-16,A00193,BIASHARA6W,72,78,150
2025-03-16,A00199,BIASHARA6W,0,100,100
2025-03-16,A00225,INUKA 4WKS,500,2500,3000
2025-03-16,A00226,INUKA6WKS,500,1167,1667
2025-03-17,A00108,BIASHARA4W,0,800,800
2025-03-17,A00140,INUKA6WKS,503,1167,1670
2025-03-17,A00142,INUKA6WKS,503,1167,1670
2025-03-17,A00150,BIASHARA6W,0,100,100
2025-03-17,A00152,BIASHARA6W,334,833,1167
2025-03-17,A00165,INUKA 4WKS,900,3500,4400
2025-03-17,A00170,INUKA6WKS,0,500,500
2025-03-17,A00180,BIASHARA4W,250,1250,1500
2025-03-17,A00181,INUKA6WKS,0,267,267
2025-03-17,A00192,INUKA6WKS,0,280,280
2025-03-17,A00232,BIASHARA4W,250,690,940
2025-03-17,A00238,BIASHARA6W,334,833,1167
2025-03-17,A00248,BIASHARA6W,134,366,500
2025-03-17,A00281,BIASHARA6W,300,0,300
2025-03-18,A00108,BIASHARA4W,250,1250,1500
2025-03-18,A00109,INUKA6WKS,0,200,200
2025-03-18,A00148,BIASHARA6W,336,834,1170
2025-03-18,A00149,INUKA6WKS,500,1170,1670
2025-03-18,A00170,INUKA6WKS,3,264,267
2025-03-18,A00183,INUKA6WKS,500,1050,1550
2025-03-18,A00190,INUKA 4WKS,500,1500,2000
2025-03-18,A00228,INUKA6WKS,500,1000,1500
2025-03-18,A00229,BIASHARA6W,12,168,180
2025-03-18,A00231,INUKA6WKS,500,1167,1667
2025-03-18,A00232,BIASHARA4W,0,560,560
2025-03-18,A00237,INUKA6WKS,500,1167,1667
2025-03-18,A00239,INUKA6WKS,500,1167,1667
2025-03-18,A00248,BIASHARA6W,0,467,467
2025-03-18,A00250,INUKA6WKS,500,2000,2500
2025-03-18,A00268,BIASHARA4W,250,1250,1500
2025-03-18,A00282,INUKA6WKS,250,0,250
2025-03-18,A00337,INUKA6WKS,500,1167,1667
2025-03-19,A00032,BIASHARA6W,200,0,200
2025-03-19,A00103,BIASHARA4W,250,1250,1500
2025-03-19,A00109,INUKA6WKS,59,491,550
2025-03-19,A00151,INUKA6WKS,503,1167,1670
2025-03-19,A00156,INUKA 4WKS,500,2000,2500
2025-03-19,A00183,INUKA6WKS,0,117,117
2025-03-19,A00191,INUKA6WKS,500,1000,1500
2025-03-19,A00192,INUKA6WKS,40,627,667
2025-03-19,A00193,BIASHARA6W,11,756,767
2025-03-19,A00194,BIASHARA6W,336,834,1170
2025-03-19,A00195,BIASHARA6W,334,833,1167
2025-03-19,A00199,BIASHARA6W,4,696,700
2025-03-19,A00229,BIASHARA6W,200,0,200
2025-03-19,A00247,BIASHARA6W,334,616,950
2025-03-19,A00249,INUKA 4WKS,500,2500,3000
2025-03-19,A00251,BIASHARA4W,250,1250,1500
2025-03-19,A00263,INUKA6WKS,500,907,1407
2025-03-19,A00264,BIASHARA6W,334,833,1167
2025-03-19,A00266,BIASHARA4W,250,1250,1500
2025-03-19,A00267,BIASHARA4W,250,750,1000
2025-03-19,A00269,BIASHARA6W,334,833,1167
2025-03-19,A00270,INUKA6WKS,500,1167,1667
2025-03-19,A00273,BIASHARA6W,366,834,1200
2025-03-19,A00281,BIASHARA6W,34,266,300
2025-03-19,A00282,INUKA6WKS,250,0,250
2025-03-20,A00109,INUKA6WKS,456,464,920
2025-03-20,A00119,BIASHARA6W,197,3,200
2025-03-20,A00120,BIASHARA6W,334,833,1167
2025-03-20,A00155,INUKA 4WKS,500,2000,2500
2025-03-20,A00156,INUKA 4WKS,500,2000,2500
2025-03-20,A00172,BIASHARA4W,250,1250,1500
2025-03-20,A00199,BIASHARA6W,100,0,100
2025-03-20,A00200,BIASHARA6W,335,835,1170
2025-03-20,A00207,INUKA6WKS,487,413,900
2025-03-20,A00208,BIASHARA4W,250,1250,1500
2025-03-20,A00247,BIASHARA6W,0,200,200
2025-03-20,A00263,INUKA6WKS,0,260,260
2025-03-20,A00271,INUKA6WKS,500,1000,1500
2025-03-20,A00274,BIASHARA6W,334,833,1167
2025-03-20,A00281,BIASHARA6W,0,568,568
2025-03-20,A00282,INUKA6WKS,0,250,250
2025-03-20,A00325,INUKA6WKS,503,1167,1670
2025-03-21,A00032,BIASHARA6W,134,66,200
2025-03-21,A00104,BIASHARA4W,250,1250,1500
2025-03-21,A00117,BIASHARA6W,334,833,1167
2025-03-21,A00118,BIASHARA4W,250,1250,1500
2025-03-21,A00119,BIASHARA6W,137,830,967
2025-03-21,A00163,INUKA 4WKS,500,1750,2250
2025-03-21,A00207,INUKA6WKS,46,754,800
2025-03-21,A00209,INUKA8WKS,485,875,1360
2025-03-21,A00210,BIASHARA6W,334,416,750
2025-03-21,A00247,BIASHARA6W,2,18,20
2025-03-21,A00280,INUKA6WKS,500,100,600
2025-03-21,A00282,INUKA6WKS,0,750,750
2025-03-21,A00283,BIASHARA6W,336,834,1170
2025-03-22,A00032,BIASHARA6W,0,200,200
2025-03-22,A00150,BIASHARA6W,331,169,500
2025-03-22,A00164,INUKA 4WKS,100,1480,1580
2025-03-22,A00170,INUKA6WKS,497,3,500
2025-03-22,A00173,BIASHARA4W,250,1250,1500
2025-03-22,A00192,INUKA6WKS,280,0,280
2025-03-22,A00202,BIASHARA6W,0,100,100
2025-03-22,A00210,BIASHARA6W,0,417,417
2025-03-22,A00229,BIASHARA6W,122,128,250
2025-03-22,A00336,INUKA6WKS,500,1000,1500
2025-03-23,A00139,INUKA 4WKS,500,1750,2250
2025-03-23,A00140,INUKA6WKS,491,709,1200
2025-03-23,A00141,BIASHARA6W,336,834,1170
2025-03-23,A00142,INUKA6WKS,503,1167,1670
2025-03-23,A00173,BIASHARA4W,250,1250,1500
2025-03-23,A00179,BIASHARA4W,250,1250,1500
2025-03-23,A00226,INUKA6WKS,500,900,1400
2025-03-24,A00012,BIASHARA6W,334,834,1168
2025-03-24,A00020,INUKA8WKS,500,875,1375
2025-03-24,A00021,BIASHARA6W,334,834,1168
2025-03-24,A00022,INUKA6WKS,500,1167,1667
2025-03-24,A00028,INUKA 4WKS,300,0,300
2025-03-24,A00033,INUKA6WKS,500,1167,1667
2025-03-24,A00085,INUKA6WKS,673,1667,2340
2025-03-24,A00117,BIASHARA6W,668,1668,2336
2025-03-24,A00119,BIASHARA6W,668,1668,2336
2025-03-24,A00140,INUKA6WKS,12,458,470
2025-03-24,A00149,INUKA6WKS,500,0,500
2025-03-24,A00150,BIASHARA6W,3,697,700
2025-03-24,A00155,INUKA 4WKS,500,2000,2500
2025-03-24,A00164,INUKA 4WKS,500,470,970
2025-03-24,A00178,INUKA 4WKS,500,1750,2250
2025-03-24,A00180,BIASHARA4W,250,1250,1500
2025-03-24,A00181,INUKA6WKS,500,1167,1667
2025-03-24,A00190,INUKA 4WKS,1000,3000,4000
2025-03-24,A00192,INUKA6WKS,180,180,360
2025-03-24,A00208,BIASHARA4W,500,2500,3000
2025-03-24,A00225,INUKA 4WKS,500,2500,3000
2025-03-24,A00226,INUKA6WKS,0,267,267
2025-03-24,A00229,BIASHARA6W,268,706,974
2025-03-24,A00232,BIASHARA4W,250,550,800
2025-03-24,A00250,INUKA6WKS,833,1667,2500
2025-03-24,A00267,BIASHARA4W,250,750,1000
2025-03-24,A00280,INUKA6WKS,0,1067,1067
2025-03-25,A00019,BIASHARA6W,334,566,900
2025-03-25,A00023,INUKA 4WKS,500,1750,2250
2025-03-25,A00025,INUKA6WKS,500,1000,1500
2025-03-25,A00026,BIASHARA4W,250,1250,1500
2025-03-25,A00028,INUKA 4WKS,200,1750,1950
2025-03-25,A00029,BIASHARA6W,334,466,800
2025-03-25,A00032,BIASHARA6W,0,567,567
2025-03-25,A00036,BIASHARA4W,500,2500,3000
2025-03-25,A00087,BIASHARA4W,250,1250,1500
2025-03-25,A00095,INUKA6WKS,500,200,700
2025-03-25,A00149,INUKA6WKS,0,1200,1200
2025-03-25,A00150,BIASHARA6W,263,137,400
2025-03-25,A00151,INUKA6WKS,503,1167,1670
2025-03-25,A00152,BIASHARA6W,334,833,1167
2025-03-25,A00179,BIASHARA4W,250,1250,1500
2025-03-25,A00180,BIASHARA4W,250,1250,1500
2025-03-25,A00183,INUKA6WKS,500,1050,1550
2025-03-25,A00228,INUKA6WKS,500,1000,1500
2025-03-25,A00231,INUKA6WKS,500,1000,1500
2025-03-25,A00232,BIASHARA4W,0,700,700
2025-03-25,A00237,INUKA6WKS,500,1100,1600
2025-03-25,A00238,BIASHARA6W,334,833,1167
2025-03-25,A00248,BIASHARA6W,334,533,867
2025-03-25,A00281,BIASHARA6W,300,0,300
2025-03-25,A00349,INUKA 4WKS,550,1750,2300
2025-03-26,A00029,BIASHARA6W,12,368,380
2025-03-26,A00088,INUKA6WKS,500,1000,1500
2025-03-26,A00095,INUKA6WKS,0,960,960
2025-03-26,A00097,INUKA6WKS,500,1167,1667
2025-03-26,A00109,INUKA6WKS,0,600,600
2025-03-26,A00149,INUKA6WKS,1000,2334,3334
2025-03-26,A00150,BIASHARA6W,71,129,200
2025-03-26,A00183,INUKA6WKS,0,117,117
2025-03-26,A00191,INUKA6WKS,500,1000,1500
2025-03-26,A00193,BIASHARA6W,323,307,630
2025-03-26,A00194,BIASHARA6W,336,834,1170
2025-03-26,A00195,BIASHARA6W,334,833,1167
2025-03-26,A00199,BIASHARA6W,200,0,200
2025-03-26,A00202,BIASHARA6W,179,21,200
2025-03-26,A00213,INUKA6WKS,6,0,6
2025-03-26,A00231,INUKA6WKS,3,167,170
2025-03-26,A00237,INUKA6WKS,0,67,67
2025-03-26,A00239,INUKA6WKS,500,500,1000
2025-03-26,A00247,BIASHARA6W,60,0,60
2025-03-26,A00248,BIASHARA6W,0,300,300
2025-03-26,A00249,INUKA 4WKS,500,2500,3000
2025-03-26,A00251,BIASHARA4W,250,1250,1500
2025-03-26,A00264,BIASHARA6W,334,833,1167
2025-03-26,A00268,BIASHARA4W,250,1200,1450
2025-03-26,A00269,BIASHARA6W,334,833,1167
2025-03-26,A00270,INUKA6WKS,500,1167,1667
2025-03-26,A00271,INUKA6WKS,500,1000,1500
2025-03-26,A00337,INUKA6WKS,497,503,1000
2025-03-27,A00062,INUKA 4WKS,500,1700,2200
2025-03-27,A00095,INUKA6WKS,3,7,10
2025-03-27,A00102,INUKA6WKS,500,700,1200
2025-03-27,A00109,INUKA6WKS,500,570,1070
2025-03-27,A00133,INUKA8WKS,500,500,1000
2025-03-27,A00159,BIASHARA6W,366,834,1200
2025-03-27,A00164,INUKA 4WKS,0,1550,1550
2025-03-27,A00170,INUKA6WKS,36,1164,1200
2025-03-27,A00172,BIASHARA4W,250,1250,1500
2025-03-27,A00193,BIASHARA6W,0,440,440
2025-03-27,A00199,BIASHARA6W,36,834,870
2025-03-27,A00200,BIASHARA6W,333,834,1167
2025-03-27,A00201,BIASHARA6W,334,834,1168
2025-03-27,A00207,INUKA6WKS,454,416,870
2025-03-27,A00215,BIASHARA6W,336,834,1170
2025-03-27,A00263,INUKA6WKS,500,1167,1667
2025-03-27,A00266,BIASHARA4W,250,1250,1500
2025-03-27,A00268,BIASHARA4W,0,50,50
2025-03-27,A00273,BIASHARA6W,306,834,1140
2025-03-27,A00274,BIASHARA6W,335,835,1170
2025-03-27,A00282,INUKA6WKS,500,300,800
2025-03-27,A00319,BIASHARA6W,200,0,200
2025-03-27,A00325,INUKA6WKS,1003,2334,3337
2025-03-28,A00062,INUKA 4WKS,0,300,300
2025-03-28,A00102,INUKA6WKS,0,350,350
2025-03-28,A00120,BIASHARA6W,334,833,1167
2025-03-28,A00123,BIASHARA6W,334,833,1167
2025-03-28,A00131,INUKA8WKS,500,1000,1500
2025-03-28,A00133,INUKA8WKS,0,375,375
2025-03-28,A00163,INUKA 4WKS,500,1750,2250
2025-03-28,A00192,INUKA6WKS,0,550,550
2025-03-28,A00207,INUKA6WKS,56,751,807
2025-03-28,A00209,INUKA8WKS,500,800,1300
2025-03-28,A00212,INUKA6WKS,500,1167,1667
2025-03-28,A00239,INUKA6WKS,0,67,67
2025-03-28,A00280,INUKA6WKS,335,0,335
2025-03-28,A00281,BIASHARA6W,368,502,870
2025-03-28,A00282,INUKA6WKS,500,200,700
2025-03-28,A00283,BIASHARA6W,332,768,1100
2025-03-28,A00319,BIASHARA6W,134,16,150
2025-03-28,A00336,INUKA6WKS,500,400,900
2025-03-28,A00337,INUKA6WKS,0,400,400
2025-03-29,A00019,BIASHARA6W,2,268,270
2025-03-29,A00090,BIASHARA4W,250,250,500
2025-03-29,A00102,INUKA6WKS,3,117,120
2025-03-29,A00148,BIASHARA6W,333,834,1167
2025-03-29,A00170,INUKA6WKS,464,526,990
2025-03-29,A00192,INUKA6WKS,100,437,537
2025-03-29,A00210,BIASHARA6W,334,833,1167
2025-03-29,A00239,INUKA6WKS,0,600,600
2025-03-29,A00247,BIASHARA6W,336,834,1170
2025-03-29,A00267,BIASHARA4W,0,300,300
2025-03-29,A00280,INUKA6WKS,165,335,500
2025-03-29,A00283,BIASHARA6W,4,66,70
2025-03-29,A00319,BIASHARA6W,0,200,200
2025-03-29,A00336,INUKA6WKS,0,600,600
2025-03-30,A00019,BIASHARA6W,332,235,567
2025-03-30,A00032,BIASHARA6W,199,1,200
2025-03-30,A00060,BIASHARA6W,334,466,800
2025-03-30,A00075,BIASHARA4W,250,150,400
2025-03-30,A00090,BIASHARA4W,0,400,400
2025-03-30,A00109,INUKA6WKS,200,0,200
2025-03-30,A00132,BIASHARA4W,500,2500,3000
2025-03-30,A00140,INUKA6WKS,488,412,900
2025-03-30,A00141,BIASHARA6W,326,269,595
2025-03-30,A00142,INUKA6WKS,503,1167,1670
2025-03-30,A00178,INUKA 4WKS,500,1750,2250
2025-03-30,A00216,BIASHARA4W,250,1250,1500
2025-03-30,A00226,INUKA6WKS,500,330,830
2025-03-30,A00280,INUKA6WKS,295,165,460
2025-03-30,A00281,BIASHARA6W,0,300,300
2025-03-30,A00319,BIASHARA6W,0,200,200
2025-03-31,A00020,INUKA8WKS,500,200,700
2025-03-31,A00021,BIASHARA6W,334,834,1168
2025-03-31,A00022,INUKA6WKS,500,1167,1667
2025-03-31,A00033,INUKA6WKS,500,1167,1667
2025-03-31,A00060,BIASHARA6W,0,367,367
2025-03-31,A00061,BIASHARA6W,334,262,596
2025-03-31,A00074,INUKA 4WKS,500,1500,2000
2025-03-31,A00075,BIASHARA4W,0,700,700
2025-03-31,A00090,BIASHARA4W,0,600,600
2025-03-31,A00091,INUKA6WKS,500,670,1170
2025-03-31,A00122,INUKA 4WKS,500,2000,2500
2025-03-31,A00124,INUKA 4WKS,500,1750,2250
2025-03-31,A00125,BIASHARA4W,250,1250,1500
2025-03-31,A00140,INUKA6WKS,15,755,770
2025-03-31,A00141,BIASHARA6W,0,500,500
2025-03-31,A00152,BIASHARA6W,334,833,1167
2025-03-31,A00170,INUKA6WKS,0,390,390
2025-03-31,A00181,INUKA6WKS,500,500,1000
2025-03-31,A00225,INUKA 4WKS,1000,5000,6000
2025-03-31,A00226,INUKA6WKS,0,837,837
2025-03-31,A00227,BIASHARA6W,334,834,1168
2025-03-31,A00229,BIASHARA6W,333,834,1167
2025-03-31,A00232,BIASHARA4W,250,485,735
2025-03-31,A00238,BIASHARA6W,334,66,400
2025-03-31,A00250,INUKA6WKS,667,1933,2600
2025-03-31,A00265,BIASHARA4W,250,1250,1500
2025-03-31,A00319,BIASHARA6W,0,417,417
2025-03-31,A00320,INUKA 4WKS,500,1750,2250
2025-03-31,A00321,INUKA 4WKS,500,1750,2250
2025-03-31,A00322,BIASHARA4W,250,1250,1500
2025-03-31,A00337,INUKA6WKS,206,61,267
2025-04-01,A00012,BIASHARA6W,334,526,860
2025-04-01,A00023,INUKA 4WKS,500,900,1400
2025-04-01,A00025,INUKA6WKS,500,1000,1500
2025-04-01,A00026,BIASHARA4W,250,1250,1500
2025-04-01,A00028,INUKA 4WKS,500,500,1000
2025-04-01,A00032,BIASHARA6W,135,665,800
2025-04-01,A00061,BIASHARA6W,0,567,567
2025-04-01,A00075,BIASHARA4W,0,400,400
2025-04-01,A00085,INUKA6WKS,333,1667,2000
2025-04-01,A00091,INUKA6WKS,3,997,1000
2025-04-01,A00097,INUKA6WKS,500,1167,1667
2025-04-01,A00109,INUKA6WKS,285,215,500
2025-04-01,A00127,INUKA6WKS,503,1667,2170
2025-04-01,A00150,BIASHARA6W,0,350,350
2025-04-01,A00151,INUKA6WKS,500,1167,1667
2025-04-01,A00170,INUKA6WKS,24,251,275
2025-04-01,A00181,INUKA6WKS,0,667,667
2025-04-01,A00183,INUKA6WKS,500,1167,1667
2025-04-01,A00231,INUKA6WKS,500,1167,1667
2025-04-01,A00232,BIASHARA4W,250,2015,2265
2025-04-01,A00237,INUKA6WKS,500,1167,1667
2025-04-01,A00238,BIASHARA6W,0,767,767
2025-04-01,A00248,BIASHARA6W,258,2,260
2025-04-01,A00266,BIASHARA4W,500,2500,3000
2025-04-01,A00272,BIASHARA4W,250,1250,1500
2025-04-01,A00280,INUKA6WKS,205,167,372
2025-04-01,A00349,INUKA 4WKS,500,1750,2250
2025-04-02,A00012,BIASHARA6W,2,308,310
2025-04-02,A00019,BIASHARA6W,0,501,501
2025-04-02,A00023,INUKA 4WKS,0,850,850
2025-04-02,A00028,INUKA 4WKS,0,1250,1250
2025-04-02,A00032,BIASHARA6W,0,68,68
2025-04-02,A00061,BIASHARA6W,0,4,4
2025-04-02,A00063,INUKA6WKS,18,0,18
2025-04-02,A00077,INUKA 4WKS,50,0,50
2025-04-02,A00087,BIASHARA4W,250,1250,1500
2025-04-02,A00095,INUKA6WKS,497,503,1000
2025-04-02,A00109,INUKA6WKS,0,950,950
2025-04-02,A00140,INUKA6WKS,485,1165,1650
2025-04-02,A00141,BIASHARA6W,10,65,75
2025-04-02,A00191,INUKA6WKS,500,1000,1500
2025-04-02,A00192,INUKA6WKS,400,600,1000
2025-04-02,A00193,BIASHARA6W,334,316,650
2025-04-02,A00194,BIASHARA6W,336,834,1170
2025-04-02,A00195,BIASHARA6W,668,999,1667
2025-04-02,A00199,BIASHARA6W,328,472,800
2025-04-02,A00209,INUKA8WKS,0,75,75
2025-04-02,A00213,INUKA6WKS,494,6,500
2025-04-02,A00228,INUKA6WKS,500,1000,1500
2025-04-02,A00230,INUKA6WKS,500,1000,1500
2025-04-02,A00239,INUKA6WKS,500,450,950
2025-04-02,A00247,BIASHARA6W,270,230,500
2025-04-02,A00248,BIASHARA6W,76,831,907
2025-04-02,A00249,INUKA 4WKS,400,2500,2900
2025-04-02,A00268,BIASHARA4W,250,1250,1500
2025-04-02,A00273,BIASHARA6W,334,834,1168
2025-04-02,A00324,BIASHARA4W,250,1250,1500
2025-04-02,A00330,INUKA8WKS,525,875,1400
2025-04-02,A00332,INUKA6WKS,506,1334,1840
2025-04-02,A00333,INUKA6WKS,503,1167,1670
2025-04-02,A00349,INUKA 4WKS,950,3500,4450
2025-04-03,A00020,INUKA8WKS,0,600,600
2025-04-03,A00088,INUKA6WKS,500,1000,1500
2025-04-03,A00102,INUKA6WKS,497,1103,1600
2025-04-03,A00133,INUKA8WKS,100,0,100
2025-04-03,A00192,INUKA6WKS,0,500,500
2025-04-03,A00193,BIASHARA6W,0,530,530
2025-04-03,A00199,BIASHARA6W,8,362,370
2025-04-03,A00200,BIASHARA6W,334,833,1167
2025-04-03,A00201,BIASHARA6W,334,834,1168
2025-04-03,A00207,INUKA6WKS,444,556,1000
2025-04-03,A00212,INUKA6WKS,500,1167,1667
2025-04-03,A00213,INUKA6WKS,8,1161,1169
2025-04-03,A00215,BIASHARA6W,334,834,1168
2025-04-03,A00239,INUKA6WKS,0,450,450
2025-04-03,A00263,INUKA6WKS,500,660,1160
2025-04-03,A00269,BIASHARA6W,334,833,1167
2025-04-03,A00270,INUKA6WKS,500,1167,1667
2025-04-03,A00271,INUKA6WKS,500,1000,1500
2025-04-03,A00274,BIASHARA6W,333,667,1000
2025-04-03,A00282,INUKA6WKS,0,700,700
2025-04-03,A00319,BIASHARA6W,199,1,200
2025-04-03,A00331,INUKA6WKS,503,1167,1670
2025-04-03,A00336,INUKA6WKS,500,1000,1500
2025-04-04,A00019,BIASHARA6W,2,98,100
2025-04-04,A00020,INUKA8WKS,0,75,75
2025-04-04,A00062,INUKA 4WKS,500,2000,2500
2025-04-04,A00102,INUKA6WKS,3,64,67
2025-04-04,A00121,INUKA6WKS,18,0,18
2025-04-04,A00131,INUKA8WKS,500,1000,1500
2025-04-04,A00133,INUKA8WKS,400,420,820
2025-04-04,A00142,INUKA6WKS,485,1165,1650
2025-04-04,A00159,BIASHARA6W,336,834,1170
2025-04-04,A00191,INUKA6WKS,1000,2000,3000
2025-04-04,A00192,INUKA6WKS,100,67,167
2025-04-04,A00207,INUKA6WKS,59,611,670
2025-04-04,A00210,BIASHARA6W,334,833,1167
2025-04-04,A00239,INUKA6WKS,0,200,200
2025-04-04,A00247,BIASHARA6W,0,480,480
2025-04-04,A00249,INUKA 4WKS,100,0,100
2025-04-04,A00251,BIASHARA4W,250,120,370
2025-04-04,A00263,INUKA6WKS,0,507,507
2025-04-04,A00274,BIASHARA6W,3,167,170
2025-04-04,A00280,INUKA6WKS,0,590,590
2025-04-04,A00281,BIASHARA6W,334,516,850
2025-04-04,A00282,INUKA6WKS,500,300,800
2025-04-04,A00283,BIASHARA6W,336,834,1170
2025-04-04,A00319,BIASHARA6W,100,0,100
2025-04-04,A00323,INUKA 4WKS,500,1750,2250
2025-04-04,A00335,BIASHARA6W,336,834,1170
2025-04-05,A00030,INUKA 4WKS,500,750,1250
2025-04-05,A00095,INUKA6WKS,0,600,600
2025-04-05,A00120,BIASHARA6W,334,839,1173
2025-04-05,A00123,BIASHARA6W,334,833,1167
2025-04-05,A00251,BIASHARA4W,0,197,197
2025-04-05,A00264,BIASHARA6W,334,833,1167
2025-04-05,A00280,INUKA6WKS,30,410,440
2025-04-05,A00319,BIASHARA6W,35,165,200
2025-04-05,A00338,INUKA6WKS,250,0,250
2025-04-06,A00030,INUKA 4WKS,0,1000,1000
2025-04-06,A00035,BIASHARA6W,334,766,1100
2025-04-06,A00054,BIASHARA6W,334,466,800
2025-04-06,A00060,BIASHARA6W,334,166,500
2025-04-06,A00133,INUKA8WKS,0,455,455
2025-04-06,A00152,BIASHARA6W,334,566,900
2025-04-06,A00192,INUKA6WKS,300,0,300
2025-04-06,A00209,INUKA8WKS,500,800,1300
2025-04-06,A00226,INUKA6WKS,500,330,830
2025-04-06,A00229,BIASHARA6W,67,633,700
2025-04-06,A00239,INUKA6WKS,1,67,68
2025-04-06,A00251,BIASHARA4W,0,800,800
2025-04-06,A00280,INUKA6WKS,300,0,300
2025-04-06,A00319,BIASHARA6W,0,200,200
2025-04-06,A00321,INUKA 4WKS,500,750,1250
2025-04-07,A00019,BIASHARA6W,332,268,600
2025-04-07,A00020,INUKA8WKS,500,500,1000
2025-04-07,A00028,INUKA 4WKS,500,1750,2250
2025-04-07,A00033,INUKA6WKS,500,1167,1667
2025-04-07,A00035,BIASHARA6W,0,65,65
2025-04-07,A00037,BIASHARA4W,300,1250,1550
2025-04-07,A00039,BIASHARA6W,334,833,1167
2025-04-07,A00054,BIASHARA6W,0,368,368
2025-04-07,A00057,BIASHARA4W,250,1250,1500
2025-04-07,A00058,BIASHARA4W,250,1250,1500
2025-04-07,A00059,INUKA 4WKS,500,2500,3000
2025-04-07,A00060,BIASHARA6W,0,500,500
2025-04-07,A00061,BIASHARA6W,334,833,1167
2025-04-07,A00074,INUKA 4WKS,500,1500,2000
2025-04-07,A00075,BIASHARA4W,250,500,750
2025-04-07,A00090,BIASHARA4W,250,1250,1500
2025-04-07,A00124,INUKA 4WKS,500,1750,2250
2025-04-07,A00141,BIASHARA6W,324,830,1154
2025-04-07,A00150,BIASHARA6W,334,466,800
2025-04-07,A00170,INUKA6WKS,476,24,500
2025-04-07,A00181,INUKA6WKS,500,1167,1667
2025-04-07,A00183,INUKA6WKS,1000,2334,3334
2025-04-07,A00193,BIASHARA6W,225,75,300
2025-04-07,A00209,INUKA8WKS,0,75,75
2025-04-07,A00210,BIASHARA6W,668,1672,2340
2025-04-07,A00216,BIASHARA4W,250,1250,1500
2025-04-07,A00226,INUKA6WKS,0,837,837
2025-04-07,A00227,BIASHARA6W,334,46,380
2025-04-07,A00229,BIASHARA6W,269,201,470
2025-04-07,A00247,BIASHARA6W,0,50,50
2025-04-07,A00251,BIASHARA4W,2,133,135
2025-04-07,A00265,BIASHARA4W,250,750,1000
2025-04-07,A00272,BIASHARA4W,250,1250,1500
2025-04-07,A00319,BIASHARA6W,0,467,467
2025-04-07,A00320,INUKA 4WKS,500,1750,2250
2025-04-07,A00321,INUKA 4WKS,0,1000,1000
2025-04-07,A00322,BIASHARA4W,250,1250,1500
2025-04-07,A00358,BIASHARA6W,10,2,12
2025-04-08,A00012,BIASHARA6W,336,834,1170
2025-04-08,A00019,BIASHARA6W,0,500,500
2025-04-08,A00020,INUKA8WKS,0,375,375
2025-04-08,A00021,BIASHARA6W,334,834,1168
2025-04-08,A00022,INUKA6WKS,500,1167,1667
2025-04-08,A00023,INUKA 4WKS,500,1750,2250
2025-04-08,A00026,BIASHARA4W,250,1250,1500
2025-04-08,A00032,BIASHARA6W,334,266,600
2025-04-08,A00036,BIASHARA4W,250,1250,1500
2025-04-08,A00055,INUKA 4WKS,500,2000,2500
2025-04-08,A00056,BIASHARA6W,334,834,1168
2025-04-08,A00063,INUKA6WKS,482,668,1150
2025-04-08,A00075,BIASHARA4W,0,750,750
2025-04-08,A00078,INUKA 4WKS,500,1750,2250
2025-04-08,A00079,BIASHARA6W,336,834,1170
2025-04-08,A00080,BIASHARA6W,336,834,1170
2025-04-08,A00081,BIASHARA6W,336,834,1170
2025-04-08,A00085,INUKA6WKS,503,1667,2170
2025-04-08,A00087,BIASHARA4W,250,1250,1500
2025-04-08,A00091,INUKA6WKS,497,503,1000
2025-04-08,A00095,INUKA6WKS,500,300,800
2025-04-08,A00122,INUKA 4WKS,500,2000,2500
2025-04-08,A00125,BIASHARA4W,50,950,1000
2025-04-08,A00127,INUKA6WKS,503,1667,2170
2025-04-08,A00151,INUKA6WKS,488,912,1400
2025-04-08,A00152,BIASHARA6W,0,267,267
2025-04-08,A00193,BIASHARA6W,109,191,300
2025-04-08,A00227,BIASHARA6W,0,788,788
2025-04-08,A00230,INUKA6WKS,500,0,500
2025-04-08,A00237,INUKA6WKS,500,700,1200
2025-04-08,A00238,BIASHARA6W,334,833,1167
2025-04-08,A00265,BIASHARA4W,0,500,500
2025-04-08,A00267,BIASHARA4W,250,1750,2000
2025-04-08,A00280,INUKA6WKS,170,170,340
2025-04-08,A00338,INUKA6WKS,250,150,400
2025-04-08,A00348,BIASHARA6W,334,834,1168
2025-04-09,A00019,BIASHARA6W,4,66,70
2025-04-09,A00023,INUKA 4WKS,500,1750,2250
2025-04-09,A00025,INUKA6WKS,500,1000,1500
2025-04-09,A00032,BIASHARA6W,0,567,567
2025-04-09,A00060,BIASHARA6W,0,168,168
2025-04-09,A00063,INUKA6WKS,21,499,520
2025-04-09,A00074,INUKA 4WKS,1000,3000,4000
2025-04-09,A00077,INUKA 4WKS,500,2000,2500
2025-04-09,A00091,INUKA6WKS,6,1164,1170
2025-04-09,A00097,INUKA6WKS,500,1167,1667
2025-04-09,A00125,BIASHARA4W,100,100,200
2025-04-09,A00151,INUKA6WKS,0,253,253
2025-04-09,A00193,BIASHARA6W,0,400,400
2025-04-09,A00194,BIASHARA6W,336,834,1170
2025-04-09,A00195,BIASHARA6W,334,1506,1840
2025-04-09,A00199,BIASHARA6W,326,674,1000
2025-04-09,A00213,INUKA6WKS,492,508,1000
2025-04-09,A00228,INUKA6WKS,500,1000,1500
2025-04-09,A00230,INUKA6WKS,0,1000,1000
2025-04-09,A00231,INUKA6WKS,500,1167,1667
2025-04-09,A00237,INUKA6WKS,0,467,467
2025-04-09,A00247,BIASHARA6W,334,666,1000
2025-04-09,A00248,BIASHARA6W,334,433,767
2025-04-09,A00250,INUKA6WKS,500,2000,2500
2025-04-09,A00251,BIASHARA4W,248,752,1000
2025-04-09,A00267,BIASHARA4W,0,200,200
2025-04-09,A00268,BIASHARA4W,250,1250,1500
2025-04-09,A00269,BIASHARA6W,334,833,1167
2025-04-09,A00270,INUKA6WKS,500,1167,1667
2025-04-09,A00324,BIASHARA4W,250,1250,1500
2025-04-09,A00332,INUKA6WKS,506,1334,1840
2025-04-09,A00338,INUKA6WKS,33,1017,1050
2025-04-10,A00092,BIASHARA6W,336,834,1170
2025-04-10,A00093,BIASHARA4W,250,1250,1500
2025-04-10,A00102,INUKA6WKS,500,1167,1667
2025-04-10,A00133,INUKA8WKS,400,0,400
2025-04-10,A00181,INUKA6WKS,500,1165,1665
2025-04-10,A00193,BIASHARA6W,0,243,243
2025-04-10,A00199,BIASHARA6W,10,160,170
2025-04-10,A00200,BIASHARA6W,334,833,1167
2025-04-10,A00201,BIASHARA6W,334,834,1168
2025-04-10,A00207,INUKA6WKS,483,1167,1650
2025-04-10,A00213,INUKA6WKS,0,640,640
2025-04-10,A00239,INUKA6WKS,499,801,1300
2025-04-10,A00248,BIASHARA6W,0,400,400
2025-04-10,A00251,BIASHARA4W,0,498,498
2025-04-10,A00264,BIASHARA6W,334,833,1167
2025-04-10,A00269,BIASHARA6W,668,1672,2340
2025-04-10,A00270,INUKA6WKS,1000,2334,3334
2025-04-10,A00271,INUKA6WKS,500,0,500
2025-04-10,A00273,BIASHARA6W,330,70,400
2025-04-10,A00274,BIASHARA6W,999,2502,3501
2025-04-10,A00280,INUKA6WKS,0,300,300
2025-04-10,A00282,INUKA6WKS,0,800,800
2025-04-10,A00283,BIASHARA6W,336,834,1170
2025-04-10,A00330,INUKA8WKS,525,875,1400
2025-04-10,A00331,INUKA6WKS,503,1167,1670
2025-04-10,A00333,INUKA6WKS,503,1167,1670
2025-04-10,A00373,BIASHARA6W,6,0,6
2025-04-11,A00062,INUKA 4WKS,500,2000,2500
2025-04-11,A00095,INUKA6WKS,3,931,934
2025-04-11,A00116,INUKA6WKS,500,1000,1500
2025-04-11,A00121,INUKA6WKS,501,1167,1668
2025-04-11,A00125,BIASHARA4W,100,100,200
2025-04-11,A00131,INUKA8WKS,500,1000,1500
2025-04-11,A00133,INUKA8WKS,170,830,1000
2025-04-11,A00192,INUKA6WKS,170,1167,1337
2025-04-11,A00194,BIASHARA6W,324,830,1154
2025-04-11,A00200,BIASHARA6W,334,834,1168
2025-04-11,A00207,INUKA6WKS,458,1165,1623
2025-04-11,A00209,INUKA8WKS,500,875,1375
2025-04-11,A00213,INUKA6WKS,1,19,20
2025-04-11,A00215,BIASHARA6W,334,834,1168
2025-04-11,A00239,INUKA6WKS,1,366,367
2025-04-11,A00273,BIASHARA6W,4,764,768
2025-04-11,A00281,BIASHARA6W,334,856,1190
2025-04-11,A00282,INUKA6WKS,500,200,700
2025-04-11,A00323,INUKA 4WKS,500,0,500
2025-04-11,A00338,INUKA6WKS,200,0,200
2025-04-11,A00380,BIASHARA6W,16,2,18
2025-04-12,A00123,BIASHARA6W,334,166,500
2025-04-12,A00159,BIASHARA6W,300,435,735
2025-04-12,A00192,INUKA6WKS,30,0,30
2025-04-12,A00212,INUKA6WKS,500,1167,1667
2025-04-12,A00263,INUKA6WKS,500,1167,1667
2025-04-12,A00271,INUKA6WKS,0,1000,1000
2025-04-12,A00323,INUKA 4WKS,0,700,700
2025-04-12,A00335,BIASHARA6W,336,834,1170
2025-04-13,A00019,BIASHARA6W,317,0,317
2025-04-13,A00035,BIASHARA6W,338,837,1175
2025-04-13,A00054,BIASHARA6W,334,666,1000
2025-04-13,A00060,BIASHARA6W,334,366,700
2025-04-13,A00075,BIASHARA4W,250,750,1000
2025-04-13,A00123,BIASHARA6W,0,668,668
2025-04-13,A00159,BIASHARA6W,0,190,190
2025-04-13,A00193,BIASHARA6W,334,373,707
2025-04-13,A00214,BIASHARA6W,334,833,1167
2025-04-13,A00216,BIASHARA4W,0,1000,1000
2025-04-13,A00226,INUKA6WKS,500,367,867
2025-04-13,A00249,INUKA 4WKS,300,2500,2800
2025-04-13,A00267,BIASHARA4W,250,250,500
2025-04-13,A00319,BIASHARA6W,78,2,80
2025-04-13,A00322,BIASHARA4W,250,750,1000
2025-04-13,A00357,BIASHARA6W,334,834,1168
2025-04-14,A00020,INUKA8WKS,500,400,900
2025-04-14,A00028,INUKA 4WKS,500,1750,2250
2025-04-14,A00030,INUKA 4WKS,500,1750,2250
2025-04-14,A00032,BIASHARA6W,98,102,200
2025-04-14,A00033,INUKA6WKS,500,1167,1667
2025-04-14,A00037,BIASHARA4W,300,1250,1550
2025-04-14,A00039,BIASHARA6W,334,834,1168
2025-04-14,A00054,BIASHARA6W,0,168,168
2025-04-14,A00057,BIASHARA4W,250,1250,1500
2025-04-14,A00059,INUKA 4WKS,500,2500,3000
2025-04-14,A00060,BIASHARA6W,0,368,368
2025-04-14,A00061,BIASHARA6W,334,466,800
2025-04-14,A00075,BIASHARA4W,0,500,500
2025-04-14,A00090,BIASHARA4W,250,1250,1500
2025-04-14,A00122,INUKA 4WKS,500,2000,2500
2025-04-14,A00124,INUKA 4WKS,500,1750,2250
2025-04-14,A00125,BIASHARA4W,0,100,100
2025-04-14,A00152,BIASHARA6W,0,2,2
2025-04-14,A00157,INUKA6WKS,500,100,600
2025-04-14,A00159,BIASHARA6W,11,209,220
2025-04-14,A00226,INUKA6WKS,0,500,500
2025-04-14,A00227,BIASHARA6W,334,834,1168
2025-04-14,A00229,BIASHARA6W,333,834,1167
2025-04-14,A00250,INUKA6WKS,500,2402,2902
2025-04-14,A00265,BIASHARA4W,250,750,1000
2025-04-14,A00272,BIASHARA4W,500,2500,3000
2025-04-14,A00273,BIASHARA6W,664,1668,2332
2025-04-14,A00319,BIASHARA6W,256,124,380
2025-04-14,A00320,INUKA 4WKS,500,1750,2250
2025-04-14,A00321,INUKA 4WKS,500,1600,2100
2025-04-14,A00322,BIASHARA4W,0,500,500
2025-04-14,A00323,INUKA 4WKS,0,1050,1050
2025-04-14,A00337,INUKA6WKS,294,506,800
2025-04-14,A00376,INUKA6WKS,500,567,1067
2025-04-14,A00384,BIASHARA6W,2,0,2
2025-04-15,A00019,BIASHARA6W,13,587,600
2025-04-15,A00022,INUKA6WKS,500,1167,1667
2025-04-15,A00026,BIASHARA4W,250,1250,1500
2025-04-15,A00036,BIASHARA4W,250,1250,1500
2025-04-15,A00055,INUKA 4WKS,500,2000,2500
2025-04-15,A00056,BIASHARA6W,334,834,1168
2025-04-15,A00057,BIASHARA4W,500,2500,3000
2025-04-15,A00058,BIASHARA4W,250,1250,1500
2025-04-15,A00060,BIASHARA6W,0,100,100
2025-04-15,A00061,BIASHARA6W,0,368,368
2025-04-15,A00063,INUKA6WKS,300,0,300
2025-04-15,A00075,BIASHARA4W,250,1250,1500
2025-04-15,A00079,BIASHARA6W,336,834,1170
2025-04-15,A00080,BIASHARA6W,336,834,1170
2025-04-15,A00081,BIASHARA6W,366,834,1200
2025-04-15,A00085,INUKA6WKS,503,1667,2170
2025-04-15,A00087,BIASHARA4W,250,1250,1500
2025-04-15,A00091,INUKA6WKS,503,1667,2170
2025-04-15,A00125,BIASHARA4W,250,1250,1500
2025-04-15,A00127,INUKA6WKS,503,1667,2170
2025-04-15,A00157,INUKA6WKS,0,1067,1067
2025-04-15,A00199,BIASHARA6W,324,830,1154
2025-04-15,A00226,INUKA6WKS,0,300,300
2025-04-15,A00230,INUKA6WKS,500,200,700
2025-04-15,A00231,INUKA6WKS,500,1167,1667
2025-04-15,A00237,INUKA6WKS,1000,2334,3334
2025-04-15,A00238,BIASHARA6W,334,466,800
2025-04-15,A00265,BIASHARA4W,0,500,500
2025-04-15,A00283,BIASHARA6W,660,1668,2328
2025-04-15,A00319,BIASHARA6W,0,708,708
2025-04-15,A00321,INUKA 4WKS,0,150,150
2025-04-15,A00338,INUKA6WKS,0,250,250
2025-04-15,A00348,BIASHARA6W,334,834,1168
2025-04-15,A00358,BIASHARA6W,334,766,1100
2025-04-15,A00360,BIASHARA4W,250,250,500
2025-04-15,A00361,BIASHARA6W,361,834,1195
2025-04-15,A00369,BIASHARA4W,250,1250,1500
2025-04-15,A00370,BIASHARA6W,334,166,500
2025-04-15,A00427,BIASHARA6W,11,0,11
2025-04-16,A00019,BIASHARA6W,0,100,100
2025-04-16,A00020,INUKA8WKS,0,475,475
2025-04-16,A00021,BIASHARA6W,334,726,1060
2025-04-16,A00032,BIASHARA6W,236,664,900
2025-04-16,A00063,INUKA6WKS,179,521,700
2025-04-16,A00090,BIASHARA4W,250,1250,1500
2025-04-16,A00102,INUKA6WKS,497,503,1000
2025-04-16,A00192,INUKA6WKS,400,1165,1565
2025-04-16,A00193,BIASHARA6W,0,457,457
2025-04-16,A00213,INUKA6WKS,503,1167,1670
2025-04-16,A00229,BIASHARA6W,66,830,896
2025-04-16,A00230,INUKA6WKS,0,800,800
2025-04-16,A00231,INUKA6WKS,497,1165,1662
2025-04-16,A00238,BIASHARA6W,0,367,367
2025-04-16,A00248,BIASHARA6W,334,233,567
2025-04-16,A00324,BIASHARA4W,250,750,1000
2025-04-16,A00337,INUKA6WKS,0,748,748
2025-04-16,A00338,INUKA6WKS,606,614,1220
2025-04-16,A00362,BIASHARA6W,334,834,1168
2025-04-16,A00363,BIASHARA4W,250,1250,1500
2025-04-16,A00366,BIASHARA6W,341,834,1175
2025-04-16,A00370,BIASHARA6W,0,668,668
2025-04-16,A00371,INUKA 4WKS,500,1750,2250
2025-04-16,A00376,INUKA6WKS,0,600,600
2025-04-16,A00399,INUKA6WKS,6,0,6
2025-04-16,A00400,INUKA6WKS,200,0,200
2025-04-16,A00401,INUKA6WKS,0,100,100
2025-04-16,A00402,BIASHARA6W,0,4,4
2025-04-17,A00019,BIASHARA6W,113,147,260
2025-04-17,A00021,BIASHARA6W,0,108,108
2025-04-17,A00025,INUKA6WKS,500,1000,1500
2025-04-17,A00032,BIASHARA6W,0,68,68
2025-04-17,A00062,INUKA 4WKS,500,2000,2500
2025-04-17,A00063,INUKA6WKS,0,270,270
2025-04-17,A00077,INUKA 4WKS,500,2000,2500
2025-04-17,A00092,BIASHARA6W,332,468,800
2025-04-17,A00093,BIASHARA4W,250,1250,1500
2025-04-17,A00102,INUKA6WKS,3,664,667
2025-04-17,A00201,BIASHARA6W,334,834,1168
2025-04-17,A00215,BIASHARA6W,210,0,210
2025-04-17,A00247,BIASHARA6W,334,616,950
2025-04-17,A00248,BIASHARA6W,0,600,600
2025-04-17,A00271,INUKA6WKS,1000,2000,3000
2025-04-17,A00280,INUKA6WKS,500,865,1365
2025-04-17,A00282,INUKA6WKS,0,500,500
2025-04-17,A00320,INUKA 4WKS,500,1750,2250
2025-04-17,A00321,INUKA 4WKS,500,1750,2250
2025-04-17,A00324,BIASHARA4W,0,500,500
2025-04-17,A00330,INUKA8WKS,525,875,1400
2025-04-17,A00331,INUKA6WKS,503,1167,1670
2025-04-17,A00332,INUKA6WKS,506,1334,1840
2025-04-17,A00333,INUKA6WKS,494,1106,1600
2025-04-17,A00358,BIASHARA6W,2,68,70
2025-04-17,A00378,INUKA6WKS,500,1167,1667
2025-04-17,A00427,BIASHARA6W,300,0,300
2025-04-18,A00021,BIASHARA6W,668,1668,2336
2025-04-18,A00121,INUKA6WKS,501,1167,1668
2025-04-18,A00123,BIASHARA6W,344,836,1180
2025-04-18,A00131,INUKA8WKS,500,1000,1500
2025-04-18,A00133,INUKA8WKS,500,875,1375
2025-04-18,A00148,BIASHARA6W,334,666,1000
2025-04-18,A00212,INUKA6WKS,500,1167,1667
2025-04-18,A00239,INUKA6WKS,499,501,1000
2025-04-18,A00263,INUKA6WKS,500,1167,1667
2025-04-18,A00264,BIASHARA6W,334,833,1167
2025-04-18,A00282,INUKA6WKS,500,1000,1500
2025-04-18,A00322,BIASHARA4W,250,1250,1500
2025-04-18,A00323,INUKA 4WKS,500,1250,1750
2025-04-18,A00333,INUKA6WKS,6,61,67
2025-04-18,A00338,INUKA6WKS,147,53,200
2025-04-18,A00372,BIASHARA4W,250,1250,1500
2025-04-18,A00373,BIASHARA6W,334,834,1168
2025-04-18,A00377,BIASHARA6W,336,834,1170
2025-04-18,A00379,BIASHARA6W,334,834,1168
2025-04-18,A00380,BIASHARA6W,334,833,1167
2025-04-18,A00419,BIASHARA6W,5,0,5
2025-04-19,A00092,BIASHARA6W,4,366,370
2025-04-19,A00159,BIASHARA6W,366,834,1200
2025-04-19,A00209,INUKA8WKS,500,875,1375
2025-04-19,A00319,BIASHARA6W,148,2,150
2025-04-19,A00335,BIASHARA6W,336,834,1170
2025-04-19,A00338,INUKA6WKS,0,250,250
2025-04-19,A00357,BIASHARA6W,334,834,1168
2025-04-19,A00388,INUKA6WKS,500,400,900
2025-04-20,A00035,BIASHARA6W,334,834,1168
2025-04-20,A00060,BIASHARA6W,334,666,1000
2025-04-20,A00063,INUKA6WKS,0,350,350
2025-04-20,A00215,BIASHARA6W,334,834,1168
2025-04-20,A00323,INUKA 4WKS,0,500,500
2025-04-20,A00365,INUKA 4WKS,500,0,500
2025-04-20,A00388,INUKA6WKS,0,767,767
2025-04-20,A00403,BIASHARA4W,250,550,800
2025-04-21,A00025,INUKA6WKS,1000,1000,2000
2025-04-21,A00030,INUKA 4WKS,1000,3500,4500
2025-04-21,A00033,INUKA6WKS,1000,2334,3334
2025-04-21,A00037,BIASHARA4W,300,1250,1550
2025-04-21,A00039,BIASHARA6W,334,834,1168
2025-04-21,A00054,BIASHARA6W,334,166,500
2025-04-21,A00058,BIASHARA4W,250,750,1000
2025-04-21,A00059,INUKA 4WKS,500,2500,3000
2025-04-21,A00060,BIASHARA6W,0,168,168
2025-04-21,A00061,BIASHARA6W,334,206,540
2025-04-21,A00063,INUKA6WKS,24,26,50
2025-04-21,A00091,INUKA6WKS,491,509,1000
2025-04-21,A00116,INUKA6WKS,500,500,1000
2025-04-21,A00122,INUKA 4WKS,500,2000,2500
2025-04-21,A00124,INUKA 4WKS,500,1750,2250
2025-04-21,A00132,BIASHARA4W,250,250,500
2025-04-21,A00212,INUKA6WKS,1000,2334,3334
2025-04-21,A00214,BIASHARA6W,334,833,1167
2025-04-21,A00216,BIASHARA4W,500,1500,2000
2025-04-21,A00226,INUKA6WKS,500,1165,1665
2025-04-21,A00228,INUKA6WKS,1000,2000,3000
2025-04-21,A00239,INUKA6WKS,0,367,367
2025-04-21,A00265,BIASHARA4W,250,1250,1500
2025-04-21,A00280,INUKA6WKS,0,900,900
2025-04-21,A00282,INUKA6WKS,0,1000,1000
2025-04-21,A00319,BIASHARA6W,186,114,300
2025-04-21,A00338,INUKA6WKS,14,86,100
2025-04-21,A00361,BIASHARA6W,307,423,730
2025-04-21,A00379,BIASHARA6W,0,336,336
2025-04-21,A00382,BIASHARA6W,334,834,1168
2025-04-21,A00383,INUKA6WKS,500,1667,2167
2025-04-21,A00385,BIASHARA4W,250,1250,1500
2025-04-21,A00389,INUKA 4WKS,500,1750,2250
2025-04-21,A00391,INUKA6WKS,500,1167,1667
2025-04-21,A00398,BIASHARA4W,250,1250,1500
2025-04-21,A00424,INUKA6WKS,18,0,18
2025-04-21,A00427,BIASHARA6W,23,377,400
2025-04-22,A00020,INUKA8WKS,500,875,1375
2025-04-22,A00055,INUKA 4WKS,500,2000,2500
2025-04-22,A00058,BIASHARA4W,250,1750,2000
2025-04-22,A00061,BIASHARA6W,0,628,628
2025-04-22,A00079,BIASHARA6W,336,834,1170
2025-04-22,A00085,INUKA6WKS,503,1667,2170
2025-04-22,A00091,INUKA6WKS,12,1158,1170
2025-04-22,A00127,INUKA6WKS,1000,1170,2170
2025-04-22,A00157,INUKA6WKS,500,1167,1667
2025-04-22,A00227,BIASHARA6W,334,834,1168
2025-04-22,A00238,BIASHARA6W,334,833,1167
2025-04-22,A00239,INUKA6WKS,1,299,300
2025-04-22,A00247,BIASHARA6W,334,1294,1628
2025-04-22,A00248,BIASHARA6W,334,839,1173
2025-04-22,A00280,INUKA6WKS,396,99,495
2025-04-22,A00319,BIASHARA6W,0,200,200
2025-04-22,A00337,INUKA6WKS,0,114,114
2025-04-22,A00338,INUKA6WKS,0,350,350
2025-04-22,A00348,BIASHARA6W,334,366,700
2025-04-22,A00358,BIASHARA6W,332,218,550
2025-04-22,A00369,BIASHARA4W,250,1250,1500
2025-04-22,A00370,BIASHARA6W,334,166,500
2025-04-22,A00384,BIASHARA6W,334,286,620
2025-04-22,A00387,BIASHARA4W,250,1250,1500
2025-04-22,A00390,INUKA6WKS,500,300,800
2025-04-22,A00393,BIASHARA4W,250,1250,1500
2025-04-22,A00397,BIASHARA4W,250,950,1200
2025-04-22,A00400,INUKA6WKS,500,1575,2075
2025-04-22,A00403,BIASHARA4W,0,700,700
2025-04-22,A00427,BIASHARA6W,13,457,470
2025-04-23,A00022,INUKA6WKS,500,1167,1667
2025-04-23,A00035,BIASHARA6W,998,2502,3500
2025-04-23,A00054,BIASHARA6W,0,545,545
2025-04-23,A00056,BIASHARA6W,334,834,1168
2025-04-23,A00063,INUKA6WKS,476,394,870
2025-04-23,A00077,INUKA 4WKS,450,750,1200
2025-04-23,A00081,BIASHARA6W,300,400,700
2025-04-23,A00093,BIASHARA4W,500,2500,3000
2025-04-23,A00230,INUKA6WKS,500,1000,1500
2025-04-23,A00238,BIASHARA6W,0,2,2
2025-04-23,A00239,INUKA6WKS,499,501,1000
2025-04-23,A00264,BIASHARA6W,334,833,1167
2025-04-23,A00280,INUKA6WKS,104,1832,1936
2025-04-23,A00319,BIASHARA6W,0,400,400
2025-04-23,A00324,BIASHARA4W,250,1250,1500
2025-04-23,A00332,INUKA6WKS,482,418,900
2025-04-23,A00338,INUKA6WKS,36,731,767
2025-04-23,A00348,BIASHARA6W,0,390,390
2025-04-23,A00361,BIASHARA6W,104,411,515
2025-04-23,A00362,BIASHARA6W,334,834,1168
2025-04-23,A00363,BIASHARA4W,0,700,700
2025-04-23,A00366,BIASHARA6W,341,834,1175
2025-04-23,A00370,BIASHARA6W,0,668,668
2025-04-23,A00374,INUKA6WKS,500,1167,1667
2025-04-23,A00376,INUKA6WKS,500,1167,1667
2025-04-23,A00384,BIASHARA6W,0,450,450
2025-04-23,A00390,INUKA6WKS,0,700,700
2025-04-23,A00392,INUKA6WKS,500,1167,1667
2025-04-23,A00397,BIASHARA4W,0,250,250
2025-04-23,A00400,INUKA6WKS,8,92,100
2025-04-23,A00402,BIASHARA6W,334,566,900
2025-04-23,A00404,BIASHARA4W,250,1250,1500
2025-04-23,A00407,BIASHARA6W,334,834,1168
2025-04-23,A00413,INUKA 4WKS,500,1750,2250
2025-04-23,A00417,INUKA6WKS,500,1000,1500
2025-04-24,A00032,BIASHARA6W,268,102,370
2025-04-24,A00054,BIASHARA6W,0,123,123
2025-04-24,A00063,INUKA6WKS,0,350,350
2025-04-24,A00077,INUKA 4WKS,50,1250,1300
2025-04-24,A00078,INUKA 4WKS,350,0,350
2025-04-24,A00102,INUKA6WKS,497,1070,1567
2025-04-24,A00125,BIASHARA4W,250,250,500
2025-04-24,A00213,INUKA6WKS,496,504,1000
2025-04-24,A00227,BIASHARA6W,334,834,1168
2025-04-24,A00239,INUKA6WKS,0,664,664
2025-04-24,A00263,INUKA6WKS,500,1165,1665
2025-04-24,A00264,BIASHARA6W,0,2,2
2025-04-24,A00323,INUKA 4WKS,500,1750,2250
2025-04-24,A00330,INUKA8WKS,625,875,1500
2025-04-24,A00331,INUKA6WKS,503,1167,1670
2025-04-24,A00332,INUKA6WKS,34,916,950
2025-04-24,A00338,INUKA6WKS,300,0,300
2025-04-24,A00360,BIASHARA4W,0,100,100
2025-04-24,A00373,BIASHARA6W,334,834,1168
2025-04-24,A00378,INUKA6WKS,500,660,1160
2025-04-24,A00384,BIASHARA6W,2,98,100
2025-04-24,A00397,BIASHARA4W,0,50,50
2025-04-24,A00401,INUKA6WKS,500,1167,1667
2025-04-24,A00402,BIASHARA6W,2,268,270
2025-04-24,A00408,BIASHARA6W,334,734,1068
2025-04-24,A00410,INUKA 4WKS,500,1750,2250
2025-04-24,A00411,BIASHARA6W,353,834,1187
2025-04-24,A00415,INUKA 4WKS,500,1750,2250
2025-04-25,A00019,BIASHARA6W,321,749,1070
2025-04-25,A00025,INUKA6WKS,0,1000,1000
2025-04-25,A00032,BIASHARA6W,66,84,150
2025-04-25,A00037,BIASHARA4W,100,1250,1350
2025-04-25,A00059,INUKA 4WKS,500,2500,3000
2025-04-25,A00063,INUKA6WKS,27,423,450
2025-04-25,A00078,INUKA 4WKS,150,150,300
2025-04-25,A00081,BIASHARA6W,0,100,100
2025-04-25,A00092,BIASHARA6W,336,834,1170
2025-04-25,A00102,INUKA6WKS,3,97,100
2025-04-25,A00121,INUKA6WKS,500,1167,1667
2025-04-25,A00131,INUKA8WKS,500,1000,1500
2025-04-25,A00159,BIASHARA6W,625,1668,2293
2025-04-25,A00201,BIASHARA6W,334,834,1168
2025-04-25,A00213,INUKA6WKS,0,300,300
2025-04-25,A00215,BIASHARA6W,122,478,600
2025-04-25,A00319,BIASHARA6W,0,120,120
2025-04-25,A00338,INUKA6WKS,164,36,200
2025-04-25,A00348,BIASHARA6W,0,78,78
2025-04-25,A00358,BIASHARA6W,0,610,610
2025-04-25,A00374,INUKA6WKS,500,1167,1667
2025-04-25,A00377,BIASHARA6W,336,834,1170
2025-04-25,A00378,INUKA6WKS,0,507,507
2025-04-25,A00379,BIASHARA6W,334,494,828
2025-04-25,A00380,BIASHARA6W,334,833,1167
2025-04-25,A00412,INUKA6WKS,500,1000,1500
2025-04-25,A00418,BIASHARA4W,250,1250,1500
2025-04-25,A00420,INUKA6WKS,500,1167,1667
2025-04-25,A00455,BIASHARA6W,38,0,38
2025-04-25,A00790,INUKA 4WKS,500,1000,1500
2025-04-26,A00019,BIASHARA6W,15,85,100
2025-04-26,A00123,BIASHARA6W,336,834,1170
2025-04-26,A00125,BIASHARA4W,0,1000,1000
2025-04-26,A00133,INUKA8WKS,100,500,600
2025-04-26,A00170,INUKA6WKS,0,500,500
2025-04-26,A00209,INUKA8WKS,505,875,1380
2025-04-26,A00213,INUKA6WKS,4,363,367
2025-04-26,A00215,BIASHARA6W,144,356,500
2025-04-26,A00363,BIASHARA4W,250,550,800
2025-04-26,A00434,INUKA 4WKS,500,1000,1500
2025-04-26,A00444,BIASHARA4W,250,250,500
2025-04-26,A00451,BIASHARA4W,220,0,220
2025-04-27,A00060,BIASHARA6W,334,166,500
2025-04-27,A00133,INUKA8WKS,400,375,775
2025-04-27,A00338,INUKA6WKS,0,200,200
2025-04-27,A00361,BIASHARA6W,167,0,167
2025-04-27,A00371,INUKA 4WKS,1500,5250,6750
2025-04-27,A00388,INUKA6WKS,500,100,600
2025-04-27,A00414,INUKA 4WKS,750,2250,3000
2025-04-27,A00421,BIASHARA4W,250,750,1000
2025-04-27,A00424,INUKA6WKS,500,0,500
2025-04-27,A00426,INUKA6WKS,500,1000,1500
2025-04-27,A00427,BIASHARA6W,321,349,670
2025-04-27,A00435,INUKA6WKS,500,1167,1667
2025-04-27,A00436,BIASHARA6W,334,734,1068
2025-04-28,A00019,BIASHARA6W,100,0,100
2025-04-28,A00032,BIASHARA6W,0,350,350
2025-04-28,A00039,BIASHARA6W,334,835,1169
2025-04-28,A00055,INUKA 4WKS,500,2000,2500
2025-04-28,A00060,BIASHARA6W,334,1499,1833
2025-04-28,A00061,BIASHARA6W,334,166,500
2025-04-28,A00091,INUKA6WKS,988,1682,2670
2025-04-28,A00105,INUKA6WKS,490,0,490
2025-04-28,A00213,INUKA6WKS,996,2334,3330
2025-04-28,A00214,BIASHARA6W,351,836,1187
2025-04-28,A00227,BIASHARA6W,334,830,1164
2025-04-28,A00319,BIASHARA6W,668,1668,2336
2025-04-28,A00333,INUKA6WKS,503,1167,1670
2025-04-28,A00357,BIASHARA6W,334,834,1168
2025-04-28,A00365,INUKA 4WKS,0,1210,1210
2025-04-28,A00382,BIASHARA6W,334,466,800
2025-04-28,A00383,INUKA6WKS,500,1667,2167
2025-04-28,A00384,BIASHARA6W,336,834,1170
2025-04-28,A00385,BIASHARA4W,250,1250,1500
2025-04-28,A00387,BIASHARA4W,250,1250,1500
2025-04-28,A00388,INUKA6WKS,0,1067,1067
2025-04-28,A00389,INUKA 4WKS,500,1400,1900
2025-04-28,A00398,BIASHARA4W,250,1250,1500
2025-04-28,A00419,BIASHARA6W,334,834,1168
2025-04-28,A00421,BIASHARA4W,0,500,500
2025-04-28,A00422,BIASHARA4W,250,1250,1500
2025-04-28,A00423,INUKA6WKS,500,1000,1500
2025-04-28,A00424,INUKA6WKS,0,1167,1167
2025-04-28,A00425,INUKA 4WKS,500,2250,2750
2025-04-28,A00426,INUKA6WKS,0,167,167
2025-04-28,A00427,BIASHARA6W,0,350,350
2025-04-28,A00429,INUKA 4WKS,500,1750,2250
2025-04-28,A00434,INUKA 4WKS,0,500,500
2025-04-28,A00436,BIASHARA6W,0,100,100
2025-04-28,A00437,INUKA 4WKS,500,500,1000
2025-04-28,A00438,BIASHARA6W,300,0,300
2025-04-28,A00451,BIASHARA4W,30,220,250
2025-04-28,A00463,INUKA6WKS,6,0,6
2025-04-28,A00464,BIASHARA6W,63,0,63
2025-04-29,A00020,INUKA8WKS,500,875,1375
2025-04-29,A00022,INUKA6WKS,500,1165,1665
2025-04-29,A00054,BIASHARA6W,334,834,1168
2025-04-29,A00061,BIASHARA6W,334,1500,1834
2025-04-29,A00077,INUKA 4WKS,450,2000,2450
2025-04-29,A00079,BIASHARA6W,672,1668,2340
2025-04-29,A00081,BIASHARA6W,34,334,368
2025-04-29,A00085,INUKA6WKS,485,1665,2150
2025-04-29,A00091,INUKA6WKS,0,1650,1650
2025-04-29,A00127,INUKA6WKS,491,1679,2170
2025-04-29,A00131,INUKA8WKS,1500,3000,4500
2025-04-29,A00133,INUKA8WKS,100,550,650
2025-04-29,A00157,INUKA6WKS,500,1100,1600
2025-04-29,A00170,INUKA6WKS,0,500,500
2025-04-29,A00230,INUKA6WKS,1000,2000,3000
2025-04-29,A00332,INUKA6WKS,966,2668,3634
2025-04-29,A00338,INUKA6WKS,0,200,200
2025-04-29,A00358,BIASHARA6W,334,146,480
2025-04-29,A00361,BIASHARA6W,63,437,500
2025-04-29,A00369,BIASHARA4W,250,1250,1500
2025-04-29,A00382,BIASHARA6W,0,368,368
2025-04-29,A00389,INUKA 4WKS,0,350,350
2025-04-29,A00390,INUKA6WKS,500,350,850
2025-04-29,A00391,INUKA6WKS,500,1167,1667
2025-04-29,A00393,BIASHARA4W,250,1250,1500
2025-04-29,A00397,BIASHARA4W,250,230,480
2025-04-29,A00403,BIASHARA4W,250,1250,1500
2025-04-29,A00427,BIASHARA6W,15,135,150
2025-04-29,A00428,INUKA 4WKS,500,2000,2500
2025-04-29,A00430,INUKA6WKS,500,1000,1500
2025-04-29,A00437,INUKA 4WKS,0,1000,1000
2025-04-29,A00438,BIASHARA6W,34,834,868
2025-04-29,A00439,BIASHARA4W,250,1250,1500
2025-04-29,A00443,BIASHARA6W,334,266,600
2025-04-29,A00444,BIASHARA4W,0,1000,1000
2025-04-29,A00447,BIASHARA4W,250,1250,1500
2025-04-29,A00451,BIASHARA4W,0,220,220
2025-04-29,A00459,INUKA6WKS,20,0,20
2025-04-29,A00471,BIASHARA6W,17,0,17
2025-04-29,A00472,INUKA6WKS,33,485,518
2025-04-30,A00056,BIASHARA6W,334,834,1168
2025-04-30,A00063,INUKA6WKS,503,1167,1670
2025-04-30,A00078,INUKA 4WKS,0,500,500
2025-04-30,A00081,BIASHARA6W,300,500,800
2025-04-30,A00088,INUKA6WKS,1000,1500,2500
2025-04-30,A00148,BIASHARA6W,329,1002,1331
2025-04-30,A00201,BIASHARA6W,334,830,1164
2025-04-30,A00333,INUKA6WKS,503,1167,1670
2025-04-30,A00335,BIASHARA6W,334,834,1168
2025-04-30,A00338,INUKA6WKS,36,731,767
2025-04-30,A00348,BIASHARA6W,334,834,1168
2025-04-30,A00358,BIASHARA6W,0,200,200
2025-04-30,A00361,BIASHARA6W,3,397,400
2025-04-30,A00362,BIASHARA6W,334,834,1168
2025-04-30,A00363,BIASHARA4W,250,750,1000
2025-04-30,A00366,BIASHARA6W,366,834,1200
2025-04-30,A00370,BIASHARA6W,334,834,1168
2025-04-30,A00372,BIASHARA4W,250,1250,1500
2025-04-30,A00376,INUKA6WKS,500,567,1067
2025-04-30,A00385,BIASHARA4W,500,2500,3000
2025-04-30,A00390,INUKA6WKS,0,650,650
2025-04-30,A00392,INUKA6WKS,500,1167,1667
2025-04-30,A00400,INUKA6WKS,508,1667,2175
2025-04-30,A00401,INUKA6WKS,500,100,600
2025-04-30,A00404,BIASHARA4W,250,1250,1500
2025-04-30,A00407,BIASHARA6W,334,766,1100
2025-04-30,A00440,BIASHARA4W,250,1250,1500
2025-04-30,A00443,BIASHARA6W,17,568,585
2025-04-30,A00451,BIASHARA4W,0,300,300
2025-05-01,A00032,BIASHARA6W,0,200,200
2025-05-01,A00079,BIASHARA6W,324,830,1154
2025-05-01,A00081,BIASHARA6W,0,320,320
2025-05-01,A00092,BIASHARA6W,328,262,590
2025-05-01,A00102,INUKA6WKS,497,553,1050
2025-05-01,A00105,INUKA6WKS,10,990,1000
2025-05-01,A00157,INUKA6WKS,0,67,67
2025-05-01,A00330,INUKA8WKS,525,875,1400
2025-05-01,A00331,INUKA6WKS,503,1167,1670
2025-05-01,A00365,INUKA 4WKS,250,540,790
2025-05-01,A00372,BIASHARA4W,500,2500,3000
2025-05-01,A00376,INUKA6WKS,0,600,600
2025-05-01,A00378,INUKA6WKS,500,1167,1667
2025-05-01,A00379,BIASHARA6W,0,168,168
2025-05-01,A00407,BIASHARA6W,12,68,80
2025-05-01,A00411,BIASHARA6W,334,834,1168
2025-05-01,A00413,INUKA 4WKS,500,1750,2250
2025-05-01,A00415,INUKA 4WKS,500,1750,2250
2025-05-01,A00417,INUKA6WKS,500,0,500
2025-05-01,A00451,BIASHARA4W,0,510,510
2025-05-01,A00452,BIASHARA6W,334,833,1167
2025-05-01,A00454,BIASHARA4W,250,1250,1500
2025-05-01,A00458,INUKA6WKS,500,1667,2167
2025-05-01,A00479,BIASHARA4W,250,1250,1500
2025-05-02,A00019,BIASHARA6W,119,581,700
2025-05-02,A00032,BIASHARA6W,100,200,300
2025-05-02,A00078,INUKA 4WKS,0,300,300
2025-05-02,A00092,BIASHARA6W,8,572,580
2025-05-02,A00102,INUKA6WKS,0,612,612
2025-05-02,A00105,INUKA6WKS,290,10,300
2025-05-02,A00121,INUKA6WKS,500,1167,1667
2025-05-02,A00133,INUKA8WKS,400,325,725
2025-05-02,A00209,INUKA8WKS,495,875,1370
2025-05-02,A00215,BIASHARA6W,190,830,1020
2025-05-02,A00331,INUKA6WKS,485,1165,1650
2025-05-02,A00333,INUKA6WKS,488,1165,1653
2025-05-02,A00338,INUKA6WKS,250,0,250
2025-05-02,A00358,BIASHARA6W,0,400,400
2025-05-02,A00377,BIASHARA6W,336,834,1170
2025-05-02,A00379,BIASHARA6W,334,316,650
2025-05-02,A00401,INUKA6WKS,0,800,800
2025-05-02,A00403,BIASHARA4W,500,2500,3000
2025-05-02,A00404,BIASHARA4W,500,2500,3000
2025-05-02,A00410,INUKA 4WKS,500,1750,2250
2025-05-02,A00412,INUKA6WKS,500,1000,1500
2025-05-02,A00414,INUKA 4WKS,250,1200,1450
2025-05-02,A00417,INUKA6WKS,0,1000,1000
2025-05-02,A00418,BIASHARA4W,250,1250,1500
2025-05-02,A00419,BIASHARA6W,334,666,1000
2025-05-02,A00420,INUKA6WKS,500,1167,1667
2025-05-02,A00448,BIASHARA4W,250,1250,1500
2025-05-02,A00449,INUKA 4WKS,500,1750,2250
2025-05-02,A00453,INUKA6WKS,500,800,1300
2025-05-02,A00455,BIASHARA6W,334,311,645
2025-05-02,A00456,INUKA 4WKS,500,2500,3000
2025-05-02,A00486,INUKA6WKS,0,15,15
2025-05-02,A00491,INUKA8WKS,5,0,5
2025-05-02,A00541,BIASHARA6W,200,0,200
2025-05-03,A00019,BIASHARA6W,0,249,249
2025-05-03,A00214,BIASHARA6W,326,834,1160
2025-05-03,A00338,INUKA6WKS,214,36,250
2025-05-03,A00358,BIASHARA6W,0,88,88
2025-05-03,A00363,BIASHARA4W,0,500,500
2025-05-03,A00401,INUKA6WKS,0,267,267
2025-05-03,A00451,BIASHARA4W,200,0,200
2025-05-03,A00455,BIASHARA6W,0,218,218
2025-05-04,A00338,INUKA6WKS,0,200,200
2025-05-04,A00374,INUKA6WKS,500,1167,1667
2025-05-04,A00383,INUKA6WKS,500,1667,2167
2025-05-04,A00421,BIASHARA4W,250,750,1000
2025-05-04,A00422,BIASHARA4W,250,1250,1500
2025-05-04,A00435,INUKA6WKS,500,1167,1667
2025-05-04,A00436,BIASHARA6W,334,834,1168
2025-05-04,A00451,BIASHARA4W,50,150,200
2025-05-04,A00466,BIASHARA6W,334,406,740
2025-05-04,A00467,BIASHARA6W,334,636,970
2025-05-04,A00541,BIASHARA6W,134,666,800
2025-05-05,A00039,BIASHARA6W,334,834,1168
2025-05-05,A00081,BIASHARA6W,34,14,48
2025-05-05,A00338,INUKA6WKS,0,200,200
2025-05-05,A00357,BIASHARA6W,334,834,1168
2025-05-05,A00360,BIASHARA4W,0,200,200
2025-05-05,A00365,INUKA 4WKS,250,320,570
2025-05-05,A00380,BIASHARA6W,334,834,1168
2025-05-05,A00382,BIASHARA6W,334,266,600
2025-05-05,A00384,BIASHARA6W,330,320,650
2025-05-05,A00387,BIASHARA4W,250,250,500
2025-05-05,A00388,INUKA6WKS,503,1167,1670
2025-05-05,A00389,INUKA 4WKS,450,0,450
2025-05-05,A00391,INUKA6WKS,500,800,1300
2025-05-05,A00414,INUKA 4WKS,0,1050,1050
2025-05-05,A00419,BIASHARA6W,0,168,168
2025-05-05,A00421,BIASHARA4W,0,500,500
2025-05-05,A00423,INUKA6WKS,500,1000,1500
2025-05-05,A00425,INUKA 4WKS,500,2250,2750
2025-05-05,A00426,INUKA6WKS,500,1167,1667
2025-05-05,A00427,BIASHARA6W,319,481,800
2025-05-05,A00429,INUKA 4WKS,500,1750,2250
2025-05-05,A00430,INUKA6WKS,500,1000,1500
2025-05-05,A00453,INUKA6WKS,0,367,367
2025-05-05,A00455,BIASHARA6W,0,305,305
2025-05-05,A00463,INUKA6WKS,502,1167,1669
2025-05-05,A00464,BIASHARA6W,334,834,1168
2025-05-05,A00466,BIASHARA6W,2,428,430
2025-05-05,A00467,BIASHARA6W,2,198,200
2025-05-05,A00470,INUKA6WKS,500,0,500
2025-05-05,A00471,BIASHARA6W,200,300,500
2025-05-05,A00472,INUKA6WKS,500,0,500
2025-05-05,A00473,INUKA6WKS,300,0,300
2025-05-05,A00477,INUKA 4WKS,500,800,1300
2025-05-05,A00478,BIASHARA4W,250,550,800
2025-05-05,A00541,BIASHARA6W,0,168,168
2025-05-06,A00012,BIASHARA6W,330,670,1000
2025-05-06,A00020,INUKA8WKS,500,875,1375
2025-05-06,A00054,BIASHARA6W,334,834,1168
2025-05-06,A00097,INUKA6WKS,500,500,1000
2025-05-06,A00127,INUKA6WKS,0,1000,1000
2025-05-06,A00338,INUKA6WKS,0,200,200
2025-05-06,A00348,BIASHARA6W,334,266,600
2025-05-06,A00361,BIASHARA6W,331,236,567
2025-05-06,A00370,BIASHARA6W,334,366,700
2025-05-06,A00384,BIASHARA6W,4,514,518
2025-05-06,A00389,INUKA 4WKS,50,800,850
2025-05-06,A00390,INUKA6WKS,500,10,510
2025-05-06,A00391,INUKA6WKS,0,367,367
2025-05-06,A00392,INUKA6WKS,500,1167,1667
2025-05-06,A00393,BIASHARA4W,250,1250,1500
2025-05-06,A00397,BIASHARA4W,0,1020,1020
2025-05-06,A00398,BIASHARA4W,250,1250,1500
2025-05-06,A00427,BIASHARA6W,17,353,370
2025-05-06,A00428,INUKA 4WKS,500,2000,2500
2025-05-06,A00434,INUKA 4WKS,1500,3500,5000
2025-05-06,A00437,INUKA 4WKS,500,350,850
2025-05-06,A00438,BIASHARA6W,334,766,1100
2025-05-06,A00439,BIASHARA4W,250,750,1000
2025-05-06,A00443,BIASHARA6W,341,834,1175
2025-05-06,A00444,BIASHARA4W,250,1250,1500
2025-05-06,A00447,BIASHARA4W,250,1250,1500
2025-05-06,A00459,INUKA6WKS,501,1334,1835
2025-05-06,A00465,BIASHARA4W,250,546,796
2025-05-06,A00468,INUKA6WKS,500,1000,1500
2025-05-06,A00470,INUKA6WKS,0,1000,1000
2025-05-06,A00471,BIASHARA6W,134,366,500
2025-05-06,A00472,INUKA6WKS,0,1170,1170
2025-05-06,A00473,INUKA6WKS,200,1167,1367
2025-05-06,A00474,INUKA8WKS,500,1000,1500
2025-05-06,A00475,INUKA 4WKS,500,2000,2500
2025-05-06,A00477,INUKA 4WKS,0,950,950
2025-05-06,A00478,BIASHARA4W,0,200,200
2025-05-06,A00482,BIASHARA4W,250,1250,1500
2025-05-07,A00029,BIASHARA6W,100,0,100
2025-05-07,A00056,BIASHARA6W,334,834,1168
2025-05-07,A00063,INUKA6WKS,511,1167,1678
2025-05-07,A00127,INUKA6WKS,0,1150,1150
2025-05-07,A00214,BIASHARA6W,659,1668,2327
2025-05-07,A00335,BIASHARA6W,334,834,1168
2025-05-07,A00338,INUKA6WKS,39,531,570
2025-05-07,A00348,BIASHARA6W,0,568,568
2025-05-07,A00360,BIASHARA4W,0,155,155
2025-05-07,A00361,BIASHARA6W,2,598,600
2025-05-07,A00362,BIASHARA6W,1002,2502,3504
2025-05-07,A00363,BIASHARA4W,250,250,500
2025-05-07,A00366,BIASHARA6W,288,512,800
2025-05-07,A00369,BIASHARA4W,250,1250,1500
2025-05-07,A00370,BIASHARA6W,0,185,185
2025-05-07,A00374,INUKA6WKS,500,1167,1667
2025-05-07,A00379,BIASHARA6W,0,350,350
2025-05-07,A00389,INUKA 4WKS,0,950,950
2025-05-07,A00390,INUKA6WKS,0,990,990
2025-05-07,A00407,BIASHARA6W,334,834,1168
2025-05-07,A00410,INUKA 4WKS,500,1750,2250
2025-05-07,A00411,BIASHARA6W,334,834,1168
2025-05-07,A00413,INUKA 4WKS,500,1750,2250
2025-05-07,A00417,INUKA6WKS,500,1000,1500
2025-05-07,A00437,INUKA 4WKS,0,1150,1150
2025-05-07,A00438,BIASHARA6W,0,68,68
2025-05-07,A00439,BIASHARA4W,0,500,500
2025-05-07,A00440,BIASHARA4W,250,250,500
2025-05-07,A00451,BIASHARA4W,0,800,800
2025-05-07,A00460,INUKA 4WKS,500,2000,2500
2025-05-07,A00465,BIASHARA4W,0,700,700
2025-05-07,A00469,INUKA6WKS,500,947,1447
2025-05-07,A00471,BIASHARA6W,4,168,172
2025-05-07,A00478,BIASHARA4W,0,350,350
2025-05-07,A00480,BIASHARA6W,334,834,1168
2025-05-07,A00481,BIASHARA4W,250,550,800
2025-05-07,A00483,BIASHARA4W,250,1250,1500
2025-05-08,A00020,INUKA8WKS,500,875,1375
2025-05-08,A00032,BIASHARA6W,200,0,200
2025-05-08,A00056,BIASHARA6W,334,830,1164
2025-05-08,A00078,INUKA 4WKS,0,500,500
2025-05-08,A00081,BIASHARA6W,300,670,970
2025-05-08,A00105,INUKA6WKS,210,490,700
2025-05-08,A00157,INUKA6WKS,500,950,1450
2025-05-08,A00330,INUKA8WKS,1275,2625,3900
2025-05-08,A00360,BIASHARA4W,0,400,400
2025-05-08,A00363,BIASHARA4W,0,1000,1000
2025-05-08,A00366,BIASHARA6W,53,322,375
2025-05-08,A00370,BIASHARA6W,0,283,283
2025-05-08,A00376,INUKA6WKS,500,1167,1667
2025-05-08,A00378,INUKA6WKS,500,1000,1500
2025-05-08,A00379,BIASHARA6W,0,168,168
2025-05-08,A00382,BIASHARA6W,0,568,568
2025-05-08,A00414,INUKA 4WKS,500,2250,2750
2025-05-08,A00415,INUKA 4WKS,500,1750,2250
2025-05-08,A00418,BIASHARA4W,250,1250,1500
2025-05-08,A00424,INUKA6WKS,500,1167,1667
2025-05-08,A00440,BIASHARA4W,0,1000,1000
2025-05-08,A00451,BIASHARA4W,0,300,300
2025-05-08,A00454,BIASHARA4W,300,1250,1550
2025-05-08,A00458,INUKA6WKS,500,1667,2167
2025-05-08,A00478,BIASHARA4W,0,150,150
2025-05-08,A00481,BIASHARA4W,0,700,700
2025-05-08,A00485,INUKA 4WKS,500,2000,2500
2025-05-08,A00486,INUKA6WKS,333,917,1250
2025-05-08,A00496,INUKA6WKS,533,1167,1700
2025-05-08,A00497,BIASHARA6W,334,834,1168
2025-05-08,A00498,BIASHARA6W,334,834,1168
2025-05-08,A00514,BIASHARA6W,7,0,7
2025-05-09,A00121,INUKA6WKS,980,2334,3314
2025-05-09,A00133,INUKA8WKS,505,875,1380
2025-05-09,A00150,BIASHARA6W,0,200,200
2025-05-09,A00157,INUKA6WKS,0,217,217
2025-05-09,A00338,INUKA6WKS,200,0,200
2025-05-09,A00358,BIASHARA6W,334,316,650
2025-05-09,A00360,BIASHARA4W,250,200,450
2025-05-09,A00377,BIASHARA6W,996,2502,3498
2025-05-09,A00378,INUKA6WKS,33,167,200
2025-05-09,A00379,BIASHARA6W,328,172,500
2025-05-09,A00380,BIASHARA6W,334,834,1168
2025-05-09,A00387,BIASHARA4W,0,1000,1000
2025-05-09,A00389,INUKA 4WKS,500,1750,2250
2025-05-09,A00393,BIASHARA4W,250,1250,1500
2025-05-09,A00400,INUKA6WKS,500,1667,2167
2025-05-09,A00402,BIASHARA6W,332,368,700
2025-05-09,A00420,INUKA6WKS,500,1167,1667
2025-05-09,A00449,INUKA 4WKS,500,1750,2250
2025-05-09,A00452,BIASHARA6W,334,835,1169
2025-05-09,A00456,INUKA 4WKS,500,2500,3000
2025-05-09,A00486,INUKA6WKS,170,250,420
2025-05-09,A00488,INUKA6WKS,503,1167,1670
2025-05-09,A00491,INUKA8WKS,500,875,1375
2025-05-09,A00494,BIASHARA4W,250,1100,1350
2025-05-09,A00495,INUKA6WKS,500,1167,1667
2025-05-09,A00499,BIASHARA6W,336,834,1170
2025-05-09,A00535,INUKA6WKS,15,0,15
2025-05-09,A00536,INUKA6WKS,18,0,18
2025-05-09,A00541,BIASHARA6W,334,666,1000
2025-05-10,A00335,BIASHARA6W,328,72,400
2025-05-10,A00338,INUKA6WKS,200,0,200
2025-05-10,A00360,BIASHARA4W,0,270,270
2025-05-10,A00379,BIASHARA6W,6,94,100
2025-05-10,A00419,BIASHARA6W,334,834,1168
2025-05-10,A00448,BIASHARA4W,250,1250,1500
2025-05-10,A00455,BIASHARA6W,296,4,300
2025-05-10,A00465,BIASHARA4W,96,4,100
2025-05-10,A00494,BIASHARA4W,0,150,150
2025-05-11,A00338,INUKA6WKS,61,139,200
2025-05-11,A00358,BIASHARA6W,0,340,340
2025-05-11,A00402,BIASHARA6W,0,450,450
2025-05-11,A00421,BIASHARA4W,250,750,1000
2025-05-11,A00423,INUKA6WKS,500,500,1000
2025-05-11,A00426,INUKA6WKS,500,500,1000
2025-05-11,A00435,INUKA6WKS,500,1167,1667
2025-05-11,A00436,BIASHARA6W,334,834,1168
2025-05-11,A00453,INUKA6WKS,500,900,1400
2025-05-11,A00464,BIASHARA6W,334,834,1168
2025-05-12,A00338,INUKA6WKS,0,1026,1026
2025-05-12,A00348,BIASHARA6W,334,830,1164
2025-05-12,A00357,BIASHARA6W,668,1664,2332
2025-05-12,A00358,BIASHARA6W,334,566,900
2025-05-12,A00360,BIASHARA4W,0,200,200
2025-05-12,A00361,BIASHARA6W,332,658,990
2025-05-12,A00383,INUKA6WKS,500,1667,2167
2025-05-12,A00387,BIASHARA4W,250,250,500
2025-05-12,A00388,INUKA6WKS,497,1103,1600
2025-05-12,A00391,INUKA6WKS,1500,3501,5001
2025-05-12,A00398,BIASHARA4W,250,1250,1500
2025-05-12,A00415,INUKA 4WKS,500,1750,2250
2025-05-12,A00421,BIASHARA4W,0,500,500
2025-05-12,A00422,BIASHARA4W,250,1250,1500
2025-05-12,A00423,INUKA6WKS,0,500,500
2025-05-12,A00425,INUKA 4WKS,500,2250,2750
2025-05-12,A00427,BIASHARA6W,317,263,580
2025-05-12,A00428,INUKA 4WKS,1000,4000,5000
2025-05-12,A00429,INUKA 4WKS,1000,3500,4500
2025-05-12,A00444,BIASHARA4W,250,1250,1500
2025-05-12,A00447,BIASHARA4W,250,1250,1500
2025-05-12,A00453,INUKA6WKS,0,267,267
2025-05-12,A00455,BIASHARA6W,0,295,295
2025-05-12,A00459,INUKA6WKS,506,1334,1840
2025-05-12,A00463,INUKA6WKS,503,1167,1670
2025-05-12,A00465,BIASHARA4W,154,146,300
2025-05-12,A00466,BIASHARA6W,334,834,1168
2025-05-12,A00470,INUKA6WKS,500,250,750
2025-05-12,A00471,BIASHARA6W,200,0,200
2025-05-12,A00473,INUKA6WKS,500,167,667
2025-05-12,A00505,BIASHARA6W,334,834,1168
2025-05-12,A00507,BIASHARA4W,250,1250,1500
2025-05-12,A00541,BIASHARA6W,0,168,168
2025-05-12,A00543,INUKA6WKS,39,0,39
2025-05-12,A00556,BIASHARA6W,20,0,20
2025-05-12,A00557,BIASHARA6W,20,0,20
2025-05-12,A00787,BIASHARA4W,0,4,4
2025-05-13,A00039,BIASHARA6W,334,830,1164
2025-05-13,A00054,BIASHARA6W,334,830,1164
2025-05-13,A00063,INUKA6WKS,459,1165,1624
2025-05-13,A00078,INUKA 4WKS,200,300,500
2025-05-13,A00081,BIASHARA6W,0,100,100
2025-05-13,A00092,BIASHARA6W,334,834,1168
2025-05-13,A00105,INUKA6WKS,0,300,300
2025-05-13,A00335,BIASHARA6W,0,500,500
2025-05-13,A00360,BIASHARA4W,0,200,200
2025-05-13,A00361,BIASHARA6W,74,176,250
2025-05-13,A00379,BIASHARA6W,0,400,400
2025-05-13,A00384,BIASHARA6W,328,372,700
2025-05-13,A00388,INUKA6WKS,70,64,134
2025-05-13,A00390,INUKA6WKS,500,0,500
2025-05-13,A00392,INUKA6WKS,500,1167,1667
2025-05-13,A00410,INUKA 4WKS,500,1750,2250
2025-05-13,A00412,INUKA6WKS,500,1000,1500
2025-05-13,A00413,INUKA 4WKS,500,1750,2250
2025-05-13,A00417,INUKA6WKS,500,1000,1500
2025-05-13,A00418,BIASHARA4W,250,1250,1500
2025-05-13,A00427,BIASHARA6W,19,571,590
2025-05-13,A00437,INUKA 4WKS,500,380,880
2025-05-13,A00438,BIASHARA6W,334,816,1150
2025-05-13,A00439,BIASHARA4W,250,750,1000
2025-05-13,A00443,BIASHARA6W,341,834,1175
2025-05-13,A00455,BIASHARA6W,0,490,490
2025-05-13,A00456,INUKA 4WKS,1000,5000,6000
2025-05-13,A00465,BIASHARA4W,0,300,300
2025-05-13,A00467,BIASHARA6W,332,468,800
2025-05-13,A00470,INUKA6WKS,0,750,750
2025-05-13,A00472,INUKA6WKS,500,1670,2170
2025-05-13,A00473,INUKA6WKS,0,1000,1000
2025-05-13,A00474,INUKA8WKS,500,950,1450
2025-05-13,A00477,INUKA 4WKS,500,1750,2250
2025-05-13,A00479,BIASHARA4W,250,550,800
2025-05-13,A00503,INUKA6WKS,503,1667,2170
2025-05-13,A00506,BIASHARA6W,334,834,1168
2025-05-13,A00509,BIASHARA6W,366,834,1200
2025-05-13,A00512,BIASHARA6W,334,466,800
2025-05-13,A00529,BIASHARA4W,250,50,300
2025-05-13,A00560,INUKA6WKS,0,44,44
2025-05-13,A00790,INUKA 4WKS,0,500,500
2025-05-14,A00012,BIASHARA6W,334,176,510
2025-05-14,A00032,BIASHARA6W,34,366,400
2025-05-14,A00170,INUKA6WKS,107,143,250
2025-05-14,A00335,BIASHARA6W,0,258,258
2025-05-14,A00358,BIASHARA6W,0,450,450
2025-05-14,A00360,BIASHARA4W,0,180,180
2025-05-14,A00376,INUKA6WKS,500,1167,1667
2025-05-14,A00384,BIASHARA6W,0,200,200
2025-05-14,A00390,INUKA6WKS,0,450,450
2025-05-14,A00411,BIASHARA6W,315,485,800
2025-05-14,A00426,INUKA6WKS,0,667,667
2025-05-14,A00430,INUKA6WKS,500,500,1000
2025-05-14,A00437,INUKA 4WKS,0,540,540
2025-05-14,A00438,BIASHARA6W,2,18,20
2025-05-14,A00439,BIASHARA4W,0,500,500
2025-05-14,A00440,BIASHARA4W,300,1250,1550
2025-05-14,A00455,BIASHARA6W,55,45,100
2025-05-14,A00465,BIASHARA4W,0,800,800
2025-05-14,A00467,BIASHARA6W,2,366,368
2025-05-14,A00469,INUKA6WKS,40,220,260
2025-05-14,A00471,BIASHARA6W,130,170,300
2025-05-14,A00474,INUKA8WKS,0,50,50
2025-05-14,A00475,INUKA 4WKS,500,500,1000
2025-05-14,A00478,BIASHARA4W,250,1250,1500
2025-05-14,A00479,BIASHARA4W,0,700,700
2025-05-14,A00480,BIASHARA6W,334,834,1168
2025-05-14,A00481,BIASHARA4W,250,150,400
2025-05-14,A00482,BIASHARA4W,250,1250,1500
2025-05-14,A00483,BIASHARA4W,250,1250,1500
2025-05-14,A00485,INUKA 4WKS,500,500,1000
2025-05-14,A00487,INUKA8WKS,500,875,1375
2025-05-14,A00496,INUKA6WKS,467,463,930
2025-05-14,A00511,BIASHARA6W,334,566,900
2025-05-14,A00512,BIASHARA6W,0,368,368
2025-05-14,A00513,BIASHARA6W,336,834,1170
2025-05-14,A00520,BIASHARA6W,334,416,750
2025-05-14,A00521,BIASHARA4W,250,1250,1500
2025-05-14,A00522,BIASHARA6W,336,834,1170
2025-05-14,A00523,BIASHARA6W,336,834,1170
2025-05-14,A00524,INUKA6WKS,500,1167,1667
2025-05-14,A00543,INUKA6WKS,250,0,250
2025-05-14,A00934,BIASHARA6W,12,0,12
2025-05-15,A00032,BIASHARA6W,0,464,464
2025-05-15,A00081,BIASHARA6W,334,898,1232
2025-05-15,A00123,BIASHARA6W,322,830,1152
2025-05-15,A00360,BIASHARA4W,0,150,150
2025-05-15,A00365,INUKA 4WKS,0,140,140
2025-05-15,A00370,BIASHARA6W,334,834,1168
2025-05-15,A00374,INUKA6WKS,500,1167,1667
2025-05-15,A00378,INUKA6WKS,500,1167,1667
2025-05-15,A00379,BIASHARA6W,0,168,168
2025-05-15,A00382,BIASHARA6W,334,466,800
2025-05-15,A00384,BIASHARA6W,8,262,270
2025-05-15,A00390,INUKA6WKS,0,550,550
2025-05-15,A00397,BIASHARA4W,200,0,200
2025-05-15,A00411,BIASHARA6W,19,349,368
2025-05-15,A00414,INUKA 4WKS,500,2250,2750
2025-05-15,A00430,INUKA6WKS,0,500,500
2025-05-15,A00437,INUKA 4WKS,0,580,580
2025-05-15,A00451,BIASHARA4W,250,730,980
2025-05-15,A00452,BIASHARA6W,334,834,1168
2025-05-15,A00458,INUKA6WKS,500,1667,2167
2025-05-15,A00471,BIASHARA6W,24,664,688
2025-05-15,A00485,INUKA 4WKS,0,1500,1500
2025-05-15,A00496,INUKA6WKS,96,704,800
2025-05-15,A00497,BIASHARA6W,334,834,1168
2025-05-15,A00498,BIASHARA6W,334,834,1168
2025-05-15,A00514,BIASHARA6W,334,706,1040
2025-05-15,A00515,INUKA8WKS,525,875,1400
2025-05-15,A00520,BIASHARA6W,0,418,418
2025-05-15,A00525,BIASHARA6W,334,834,1168
2025-05-15,A00526,BIASHARA4W,250,1250,1500
2025-05-15,A00528,BIASHARA4W,250,1250,1500
2025-05-15,A00537,INUKA6WKS,500,100,600
2025-05-15,A00538,INUKA 4WKS,500,1750,2250
2025-05-15,A00543,INUKA6WKS,200,0,200
2025-05-16,A00157,INUKA6WKS,500,1100,1600
2025-05-16,A00360,BIASHARA4W,0,170,170
2025-05-16,A00376,INUKA6WKS,500,1165,1665
2025-05-16,A00378,INUKA6WKS,467,1165,1632
2025-05-16,A00380,BIASHARA6W,652,1668,2320
2025-05-16,A00382,BIASHARA6W,0,368,368
2025-05-16,A00384,BIASHARA6W,660,1668,2328
2025-05-16,A00400,INUKA6WKS,484,683,1167
2025-05-16,A00407,BIASHARA6W,334,834,1168
2025-05-16,A00411,BIASHARA6W,649,1668,2317
2025-05-16,A00419,BIASHARA6W,334,666,1000
2025-05-16,A00420,INUKA6WKS,500,1167,1667
2025-05-16,A00449,INUKA 4WKS,1000,3500,4500
2025-05-16,A00451,BIASHARA4W,0,520,520
2025-05-16,A00454,BIASHARA4W,300,1250,1550
2025-05-16,A00460,INUKA 4WKS,500,2000,2500
2025-05-16,A00468,INUKA6WKS,500,1000,1500
2025-05-16,A00469,INUKA6WKS,460,540,1000
2025-05-16,A00475,INUKA 4WKS,0,500,500
2025-05-16,A00481,BIASHARA4W,0,600,600
2025-05-16,A00486,INUKA6WKS,330,670,1000
2025-05-16,A00488,INUKA6WKS,503,1167,1670
2025-05-16,A00494,BIASHARA4W,250,1010,1260
2025-05-16,A00504,BIASHARA6W,334,336,670
2025-05-16,A00511,BIASHARA6W,0,200,200
2025-05-16,A00514,BIASHARA6W,0,128,128
2025-05-16,A00529,BIASHARA4W,0,600,600
2025-05-16,A00534,INUKA 4WKS,500,1750,2250
2025-05-16,A00537,INUKA6WKS,0,1067,1067
2025-05-16,A00539,INUKA8WKS,500,875,1375
2025-05-16,A00543,INUKA6WKS,50,150,200
2025-05-16,A00579,BIASHARA6W,282,0,282
2025-05-16,A00580,INUKA 4WKS,0,100,100
2025-05-16,A00581,BIASHARA6W,8,0,8
2025-05-16,A00583,INUKA6WKS,75,0,75
2025-05-17,A00092,BIASHARA6W,326,174,500
2025-05-17,A00133,INUKA8WKS,95,205,300
2025-05-17,A00360,BIASHARA4W,250,50,300
2025-05-17,A00387,BIASHARA4W,0,1000,1000
2025-05-17,A00402,BIASHARA6W,334,166,500
2025-05-17,A00424,INUKA6WKS,500,1167,1667
2025-05-17,A00475,INUKA 4WKS,0,500,500
2025-05-17,A00481,BIASHARA4W,0,500,500
2025-05-17,A00491,INUKA8WKS,500,875,1375
2025-05-17,A00494,BIASHARA4W,0,240,240
2025-05-17,A00495,INUKA6WKS,500,1165,1665
2025-05-17,A00503,INUKA6WKS,503,1667,2170
2025-05-17,A00529,BIASHARA4W,0,600,600
2025-05-17,A00536,INUKA6WKS,500,1500,2000
2025-05-17,A00543,INUKA6WKS,0,250,250
2025-05-18,A00133,INUKA8WKS,330,670,1000
2025-05-18,A00361,BIASHARA6W,260,830,1090
2025-05-18,A00421,BIASHARA4W,250,750,1000
2025-05-18,A00435,INUKA6WKS,500,1167,1667
2025-05-18,A00436,BIASHARA6W,334,666,1000
2025-05-18,A00464,BIASHARA6W,334,166,500
2025-05-18,A00469,INUKA6WKS,40,627,667
2025-05-18,A00543,INUKA6WKS,0,200,200
2025-05-18,A00544,INUKA 4WKS,500,2250,2750
2025-05-18,A00554,BIASHARA4W,250,1250,1500
2025-05-18,A00555,BIASHARA4W,250,1000,1250
2025-05-18,A00556,BIASHARA6W,336,834,1170
2025-05-18,A00557,BIASHARA6W,336,834,1170
2025-05-18,A00592,BIASHARA6W,0,6,6
2025-05-19,A00076,BIASHARA4W,250,1250,1500
2025-05-19,A00105,INUKA6WKS,90,210,300
2025-05-19,A00133,INUKA8WKS,0,45,45
2025-05-19,A00157,INUKA6WKS,500,1232,1732
2025-05-19,A00358,BIASHARA6W,324,826,1150
2025-05-19,A00366,BIASHARA6W,281,119,400
2025-05-19,A00383,INUKA6WKS,1000,3334,4334
2025-05-19,A00400,INUKA6WKS,16,984,1000
2025-05-19,A00402,BIASHARA6W,320,680,1000
2025-05-19,A00421,BIASHARA4W,0,500,500
2025-05-19,A00422,BIASHARA4W,250,1250,1500
2025-05-19,A00423,INUKA6WKS,1500,2000,3500
2025-05-19,A00425,INUKA 4WKS,500,2250,2750
2025-05-19,A00426,INUKA6WKS,500,500,1000
2025-05-19,A00427,BIASHARA6W,649,1668,2317
2025-05-19,A00434,INUKA 4WKS,0,1000,1000
2025-05-19,A00436,BIASHARA6W,0,168,168
2025-05-19,A00437,INUKA 4WKS,500,1500,2000
2025-05-19,A00439,BIASHARA4W,250,1250,1500
2025-05-19,A00453,INUKA6WKS,500,1167,1667
2025-05-19,A00454,BIASHARA4W,150,1250,1400
2025-05-19,A00464,BIASHARA6W,0,500,500
2025-05-19,A00466,BIASHARA6W,332,268,600
2025-05-19,A00467,BIASHARA6W,332,288,620
2025-05-19,A00470,INUKA6WKS,500,150,650
2025-05-19,A00475,INUKA 4WKS,500,500,1000
2025-05-19,A00495,INUKA6WKS,0,2,2
2025-05-19,A00505,BIASHARA6W,334,834,1168
2025-05-19,A00506,BIASHARA6W,334,834,1168
2025-05-19,A00507,BIASHARA4W,250,700,950
2025-05-19,A00535,INUKA6WKS,500,300,800
2025-05-19,A00540,INUKA 4WKS,500,1500,2000
2025-05-19,A00541,BIASHARA6W,334,834,1168
2025-05-19,A00542,INUKA 4WKS,500,1750,2250
2025-05-19,A00543,INUKA6WKS,0,567,567
2025-05-19,A00545,INUKA 4WKS,500,2000,2500
2025-05-19,A00546,INUKA 4WKS,500,1500,2000
2025-05-19,A00551,BIASHARA6W,334,834,1168
2025-05-19,A00552,BIASHARA6W,334,234,568
2025-05-19,A00553,BIASHARA4W,250,1250,1500
2025-05-19,A00555,BIASHARA4W,0,250,250
2025-05-19,A00565,BIASHARA4W,250,1250,1500
2025-05-19,A00591,BIASHARA6W,38,0,38
2025-05-19,A00593,INUKA6WKS,0,250,250
2025-05-20,A00078,INUKA 4WKS,200,0,200
2025-05-20,A00097,INUKA6WKS,0,200,200
2025-05-20,A00358,BIASHARA6W,0,4,4
2025-05-20,A00392,INUKA6WKS,500,1167,1667
2025-05-20,A00419,BIASHARA6W,0,168,168
2025-05-20,A00426,INUKA6WKS,0,200,200
2025-05-20,A00438,BIASHARA6W,332,168,500
2025-05-20,A00443,BIASHARA6W,341,834,1175
2025-05-20,A00447,BIASHARA4W,250,1250,1500
2025-05-20,A00455,BIASHARA6W,190,0,190
2025-05-20,A00459,INUKA6WKS,506,1334,1840
2025-05-20,A00464,BIASHARA6W,0,168,168
2025-05-20,A00466,BIASHARA6W,0,300,300
2025-05-20,A00467,BIASHARA6W,0,520,520
2025-05-20,A00470,INUKA6WKS,0,850,850
2025-05-20,A00471,BIASHARA6W,293,207,500
2025-05-20,A00472,INUKA6WKS,500,1670,2170
2025-05-20,A00473,INUKA6WKS,500,1100,1600
2025-05-20,A00474,INUKA8WKS,500,1000,1500
2025-05-20,A00477,INUKA 4WKS,500,1750,2250
2025-05-20,A00499,BIASHARA6W,332,308,640
2025-05-20,A00507,BIASHARA4W,0,550,550
2025-05-20,A00512,BIASHARA6W,334,534,868
2025-05-20,A00535,INUKA6WKS,0,500,500
2025-05-20,A00540,INUKA 4WKS,0,250,250
2025-05-20,A00558,INUKA 4WKS,500,1750,2250
2025-05-20,A00559,INUKA 4WKS,500,2500,3000
2025-05-20,A00560,INUKA6WKS,500,970,1470
2025-05-20,A00564,BIASHARA6W,334,834,1168
2025-05-20,A00568,BIASHARA4W,250,1250,1500
2025-05-20,A00572,BIASHARA4W,250,750,1000
2025-05-20,A00573,BIASHARA6W,334,786,1120
2025-05-21,A00360,BIASHARA4W,0,150,150
2025-05-21,A00374,INUKA6WKS,500,1165,1665
2025-05-21,A00390,INUKA6WKS,500,50,550
2025-05-21,A00397,BIASHARA4W,300,2300,2600
2025-05-21,A00400,INUKA6WKS,284,883,1167
2025-05-21,A00417,INUKA6WKS,500,1000,1500
2025-05-21,A00423,INUKA6WKS,0,1000,1000
2025-05-21,A00438,BIASHARA6W,2,666,668
2025-05-21,A00440,BIASHARA4W,200,1250,1450
2025-05-21,A00444,BIASHARA4W,250,1000,1250
2025-05-21,A00451,BIASHARA4W,250,1250,1500
2025-05-21,A00460,INUKA 4WKS,500,2000,2500
2025-05-21,A00463,INUKA6WKS,495,505,1000
2025-05-21,A00464,BIASHARA6W,939,2502,3441
2025-05-21,A00466,BIASHARA6W,2,266,268
2025-05-21,A00467,BIASHARA6W,4,26,30
2025-05-21,A00473,INUKA6WKS,0,67,67
2025-05-21,A00479,BIASHARA4W,250,1250,1500
2025-05-21,A00480,BIASHARA6W,334,834,1168
2025-05-21,A00482,BIASHARA4W,250,1250,1500
2025-05-21,A00483,BIASHARA4W,250,1250,1500
2025-05-21,A00485,INUKA 4WKS,500,2000,2500
2025-05-21,A00486,INUKA6WKS,170,497,667
2025-05-21,A00487,INUKA8WKS,500,875,1375
2025-05-21,A00504,BIASHARA6W,0,200,200
2025-05-21,A00512,BIASHARA6W,0,300,300
2025-05-21,A00513,BIASHARA6W,336,834,1170
2025-05-21,A00521,BIASHARA4W,250,850,1100
2025-05-21,A00522,BIASHARA6W,334,834,1168
2025-05-21,A00543,INUKA6WKS,200,0,200
2025-05-21,A00560,INUKA6WKS,3,197,200
2025-05-21,A00566,INUKA 4WKS,500,1250,1750
2025-05-21,A00572,BIASHARA4W,0,500,500
2025-05-21,A00573,BIASHARA6W,32,48,80
2025-05-21,A00575,BIASHARA4W,250,1250,1500
2025-05-21,A00576,BIASHARA4W,250,1250,1500
2025-05-21,A00578,BIASHARA6W,334,751,1085
2025-05-21,A00590,INUKA8WKS,60,0,60
2025-05-22,A00076,BIASHARA4W,250,250,500
2025-05-22,A00078,INUKA 4WKS,100,100,200
2025-05-22,A00366,BIASHARA6W,0,600,600
2025-05-22,A00370,BIASHARA6W,334,166,500
2025-05-22,A00379,BIASHARA6W,28,172,200
2025-05-22,A00388,INUKA6WKS,430,570,1000
2025-05-22,A00390,INUKA6WKS,0,950,950
2025-05-22,A00400,INUKA6WKS,500,1500,2000
2025-05-22,A00401,INUKA6WKS,500,500,1000
2025-05-22,A00417,INUKA6WKS,500,1000,1500
2025-05-22,A00443,BIASHARA6W,630,1668,2298
2025-05-22,A00452,BIASHARA6W,334,834,1168
2025-05-22,A00455,BIASHARA6W,89,211,300
2025-05-22,A00458,INUKA6WKS,500,1667,2167
2025-05-22,A00468,INUKA6WKS,500,1000,1500
2025-05-22,A00469,INUKA6WKS,460,540,1000
2025-05-22,A00471,BIASHARA6W,41,627,668
2025-05-22,A00478,BIASHARA4W,250,250,500
2025-05-22,A00481,BIASHARA4W,250,725,975
2025-05-22,A00483,BIASHARA4W,250,1250,1500
2025-05-22,A00495,INUKA6WKS,503,1167,1670
2025-05-22,A00497,BIASHARA6W,334,834,1168
2025-05-22,A00498,BIASHARA6W,334,834,1168
2025-05-22,A00499,BIASHARA6W,4,526,530
2025-05-22,A00514,BIASHARA6W,334,834,1168
2025-05-22,A00515,INUKA8WKS,525,875,1400
2025-05-22,A00520,BIASHARA6W,350,834,1184
2025-05-22,A00521,BIASHARA4W,0,400,400
2025-05-22,A00523,BIASHARA6W,334,834,1168
2025-05-22,A00524,INUKA6WKS,500,1100,1600
2025-05-22,A00525,BIASHARA6W,334,834,1168
2025-05-22,A00528,BIASHARA4W,250,1250,1500
2025-05-22,A00529,BIASHARA4W,250,1250,1500
2025-05-22,A00537,INUKA6WKS,500,1167,1667
2025-05-22,A00538,INUKA 4WKS,500,1750,2250
2025-05-22,A00539,INUKA8WKS,500,875,1375
2025-05-22,A00543,INUKA6WKS,200,0,200
2025-05-22,A00563,BIASHARA6W,336,834,1170
2025-05-22,A00566,INUKA 4WKS,0,500,500
2025-05-22,A00574,BIASHARA6W,334,176,510
2025-05-22,A00578,BIASHARA6W,0,83,83
2025-05-22,A00583,INUKA6WKS,500,1167,1667
2025-05-22,A00612,BIASHARA6W,0,39,39
2025-05-23,A00076,BIASHARA4W,0,300,300
2025-05-23,A00366,BIASHARA6W,334,949,1283
2025-05-23,A00370,BIASHARA6W,0,664,664
2025-05-23,A00382,BIASHARA6W,668,1668,2336
2025-05-23,A00388,INUKA6WKS,3,597,600
2025-05-23,A00400,INUKA6WKS,0,949,949
2025-05-23,A00412,INUKA6WKS,500,500,1000
2025-05-23,A00420,INUKA6WKS,500,1167,1667
2025-05-23,A00430,INUKA6WKS,500,300,800
2025-05-23,A00455,BIASHARA6W,0,185,185
2025-05-23,A00463,INUKA6WKS,0,270,270
2025-05-23,A00481,BIASHARA4W,0,525,525
2025-05-23,A00482,BIASHARA4W,250,1250,1500
2025-05-23,A00488,INUKA6WKS,503,1167,1670
2025-05-23,A00494,BIASHARA4W,250,1250,1500
2025-05-23,A00524,INUKA6WKS,0,67,67
2025-05-23,A00526,BIASHARA4W,250,1250,1500
2025-05-23,A00534,INUKA 4WKS,500,1750,2250
2025-05-23,A00536,INUKA6WKS,500,1500,2000
2025-05-23,A00543,INUKA6WKS,100,100,200
2025-05-23,A00579,BIASHARA6W,334,834,1168
2025-05-23,A00582,INUKA6WKS,500,267,767
2025-05-23,A00628,INUKA 4WKS,216,0,216
2025-05-24,A00267,BIASHARA4W,0,200,200
2025-05-24,A00426,INUKA6WKS,0,467,467
2025-05-24,A00463,INUKA6WKS,0,390,390
2025-05-24,A00469,INUKA6WKS,40,627,667
2025-05-24,A00479,BIASHARA4W,250,1250,1500
2025-05-24,A00491,INUKA8WKS,500,450,950
2025-05-24,A00543,INUKA6WKS,0,200,200
2025-05-24,A00580,INUKA 4WKS,500,1750,2250
2025-05-24,A00582,INUKA6WKS,0,600,600
2025-05-24,A00587,INUKA 4WKS,500,0,500
2025-05-24,A00592,BIASHARA6W,334,66,400
2025-05-24,A00934,BIASHARA6W,245,0,245
2025-05-25,A00430,INUKA6WKS,0,700,700
2025-05-25,A00435,INUKA6WKS,500,1167,1667
2025-05-25,A00453,INUKA6WKS,500,700,1200
2025-05-25,A00463,INUKA6WKS,97,2,99
2025-05-25,A00466,BIASHARA6W,332,168,500
2025-05-25,A00491,INUKA8WKS,0,425,425
2025-05-25,A00509,BIASHARA6W,1304,2696,4000
2025-05-25,A00541,BIASHARA6W,334,834,1168
2025-05-25,A00543,INUKA6WKS,0,200,200
2025-05-25,A00554,BIASHARA4W,250,1250,1500
2025-05-25,A00556,BIASHARA6W,341,834,1175
2025-05-25,A00557,BIASHARA6W,341,834,1175
2025-05-25,A00582,INUKA6WKS,0,300,300
2025-05-25,A00584,BIASHARA4W,250,1250,1500
2025-05-25,A00591,BIASHARA6W,334,316,650
2025-05-25,A00592,BIASHARA6W,0,400,400
2025-05-25,A00594,INUKA6WKS,500,1160,1660
2025-05-25,A00598,BIASHARA4W,250,1250,1500
2025-05-25,A00599,BIASHARA6W,334,834,1168
2025-05-26,A00105,INUKA6WKS,410,590,1000
2025-05-26,A00360,BIASHARA4W,0,200,200
2025-05-26,A00388,INUKA6WKS,400,0,400
2025-05-26,A00402,BIASHARA6W,348,952,1300
2025-05-26,A00407,BIASHARA6W,336,834,1170
2025-05-26,A00412,INUKA6WKS,500,500,1000
2025-05-26,A00426,INUKA6WKS,503,1167,1670
2025-05-26,A00436,BIASHARA6W,668,1668,2336
2025-05-26,A00438,BIASHARA6W,666,1668,2334
2025-05-26,A00444,BIASHARA4W,0,250,250
2025-05-26,A00448,BIASHARA4W,500,2500,3000
2025-05-26,A00455,BIASHARA6W,0,205,205
2025-05-26,A00460,INUKA 4WKS,500,2000,2500
2025-05-26,A00466,BIASHARA6W,0,200,200
2025-05-26,A00470,INUKA6WKS,500,350,850
2025-05-26,A00471,BIASHARA6W,293,207,500
2025-05-26,A00486,INUKA6WKS,500,1167,1667
2025-05-26,A00505,BIASHARA6W,334,834,1168
2025-05-26,A00507,BIASHARA4W,250,1250,1500
2025-05-26,A00540,INUKA 4WKS,500,500,1000
2025-05-26,A00542,INUKA 4WKS,500,850,1350
2025-05-26,A00543,INUKA6WKS,0,667,667
2025-05-26,A00544,INUKA 4WKS,500,2250,2750
2025-05-26,A00545,INUKA 4WKS,500,500,1000
2025-05-26,A00546,INUKA 4WKS,500,1500,2000
2025-05-26,A00551,BIASHARA6W,334,834,1168
2025-05-26,A00552,BIASHARA6W,0,400,400
2025-05-26,A00553,BIASHARA4W,250,1250,1500
2025-05-26,A00568,BIASHARA4W,250,750,1000
2025-05-26,A00573,BIASHARA6W,366,834,1200
2025-05-26,A00574,BIASHARA6W,0,650,650
2025-05-26,A00581,BIASHARA6W,334,834,1168
2025-05-26,A00585,INUKA6WKS,500,1665,2165
2025-05-26,A00586,INUKA 4WKS,500,2250,2750
2025-05-26,A00587,INUKA 4WKS,0,1750,1750
2025-05-26,A00588,BIASHARA6W,334,834,1168
2025-05-26,A00591,BIASHARA6W,2,518,520
2025-05-26,A00592,BIASHARA6W,32,368,400
2025-05-26,A00594,INUKA6WKS,0,7,7
2025-05-26,A00607,BIASHARA4W,250,0,250
2025-05-27,A00078,INUKA 4WKS,0,200,200
2025-05-27,A00379,BIASHARA6W,306,562,868
2025-05-27,A00388,INUKA6WKS,97,303,400
2025-05-27,A00390,INUKA6WKS,500,1000,1500
2025-05-27,A00392,INUKA6WKS,500,1165,1665
2025-05-27,A00426,INUKA6WKS,497,1165,1662
2025-05-27,A00453,INUKA6WKS,0,467,467
2025-05-27,A00455,BIASHARA6W,17,233,250
2025-05-27,A00459,INUKA6WKS,501,1334,1835
2025-05-27,A00463,INUKA6WKS,502,1167,1669
2025-05-27,A00465,BIASHARA4W,250,800,1050
2025-05-27,A00466,BIASHARA6W,0,420,420
2025-05-27,A00469,INUKA6WKS,460,940,1400
2025-05-27,A00470,INUKA6WKS,0,650,650
2025-05-27,A00471,BIASHARA6W,41,627,668
2025-05-27,A00472,INUKA6WKS,500,1670,2170
2025-05-27,A00473,INUKA6WKS,500,1167,1667
2025-05-27,A00474,INUKA8WKS,500,1000,1500
2025-05-27,A00475,INUKA 4WKS,500,4000,4500
2025-05-27,A00477,INUKA 4WKS,500,1750,2250
2025-05-27,A00478,BIASHARA4W,0,500,500
2025-05-27,A00481,BIASHARA4W,250,1250,1500
2025-05-27,A00503,INUKA6WKS,503,1667,2170
2025-05-27,A00511,BIASHARA6W,1670,4238,5908
2025-05-27,A00535,INUKA6WKS,300,200,500
2025-05-27,A00542,INUKA 4WKS,0,900,900
2025-05-27,A00545,INUKA 4WKS,0,1500,1500
2025-05-27,A00558,INUKA 4WKS,500,1750,2250
2025-05-27,A00559,INUKA 4WKS,500,2500,3000
2025-05-27,A00560,INUKA6WKS,497,503,1000
2025-05-27,A00564,BIASHARA6W,334,834,1168
2025-05-27,A00565,BIASHARA4W,250,1250,1500
2025-05-27,A00568,BIASHARA4W,0,500,500
2025-05-27,A00589,BIASHARA6W,334,266,600
2025-05-27,A00590,INUKA8WKS,500,0,500
2025-05-27,A00602,INUKA6WKS,500,0,500
2025-05-27,A00606,BIASHARA6W,334,834,1168
2025-05-27,A00608,INUKA6WKS,500,1000,1500
2025-05-27,A00640,BIASHARA4W,250,250,500
2025-05-27,A00653,INUKA 4WKS,0,50,50
2025-05-27,A00654,INUKA6WKS,3,0,3
2025-05-28,A00379,BIASHARA6W,28,272,300
2025-05-28,A00388,INUKA6WKS,0,500,500
2025-05-28,A00419,BIASHARA6W,501,834,1335
2025-05-28,A00435,INUKA6WKS,500,1165,1665
2025-05-28,A00466,BIASHARA6W,4,46,50
2025-05-28,A00468,INUKA6WKS,500,1000,1500
2025-05-28,A00471,BIASHARA6W,627,1668,2295
2025-05-28,A00473,INUKA6WKS,1000,2334,3334
2025-05-28,A00485,INUKA 4WKS,500,2000,2500
2025-05-28,A00487,INUKA8WKS,500,875,1375
2025-05-28,A00504,BIASHARA6W,202,298,500
2025-05-28,A00506,BIASHARA6W,334,834,1168
2025-05-28,A00512,BIASHARA6W,334,834,1168
2025-05-28,A00521,BIASHARA4W,250,1250,1500
2025-05-28,A00523,BIASHARA6W,332,468,800
2025-05-28,A00560,INUKA6WKS,6,664,670
2025-05-28,A00566,INUKA 4WKS,500,1750,2250
2025-05-28,A00572,BIASHARA4W,250,500,750
2025-05-28,A00576,BIASHARA4W,250,1150,1400
2025-05-28,A00589,BIASHARA6W,0,568,568
2025-05-28,A00590,INUKA8WKS,0,750,750
2025-05-28,A00600,BIASHARA4W,250,50,300
2025-05-28,A00602,INUKA6WKS,0,1000,1000
2025-05-28,A00610,BIASHARA4W,250,1250,1500
2025-05-28,A00611,INUKA 4WKS,500,1750,2250
2025-05-28,A00612,BIASHARA6W,341,834,1175
2025-05-28,A00659,BIASHARA6W,6,0,6
2025-05-29,A00092,BIASHARA6W,0,656,656
2025-05-29,A00360,BIASHARA4W,0,170,170
2025-05-29,A00388,INUKA6WKS,0,362,362
2025-05-29,A00407,BIASHARA6W,320,230,550
2025-05-29,A00452,BIASHARA6W,334,834,1168
2025-05-29,A00458,INUKA6WKS,500,1667,2167
2025-05-29,A00469,INUKA6WKS,40,227,267
2025-05-29,A00480,BIASHARA6W,334,834,1168
2025-05-29,A00494,BIASHARA4W,250,1250,1500
2025-05-29,A00497,BIASHARA6W,334,834,1168
2025-05-29,A00498,BIASHARA6W,334,834,1168
2025-05-29,A00513,BIASHARA6W,336,834,1170
2025-05-29,A00515,INUKA8WKS,525,875,1400
2025-05-29,A00520,BIASHARA6W,318,532,850
2025-05-29,A00522,BIASHARA6W,334,834,1168
2025-05-29,A00523,BIASHARA6W,2,366,368
2025-05-29,A00524,INUKA6WKS,500,1167,1667
2025-05-29,A00525,BIASHARA6W,334,116,450
2025-05-29,A00528,BIASHARA4W,250,550,800
2025-05-29,A00538,INUKA 4WKS,500,1750,2250
2025-05-29,A00540,INUKA 4WKS,0,700,700
2025-05-29,A00543,INUKA6WKS,250,0,250
2025-05-29,A00559,INUKA 4WKS,1000,5000,6000
2025-05-29,A00563,BIASHARA6W,332,368,700
2025-05-29,A00572,BIASHARA4W,0,750,750
2025-05-29,A00574,BIASHARA6W,358,842,1200
2025-05-29,A00575,BIASHARA4W,250,550,800
2025-05-29,A00576,BIASHARA4W,0,100,100
2025-05-29,A00578,BIASHARA6W,334,834,1168
2025-05-29,A00581,BIASHARA6W,334,266,600
2025-05-29,A00583,INUKA6WKS,500,1167,1667
2025-05-29,A00593,INUKA6WKS,1000,1250,2250
2025-05-29,A00613,INUKA6WKS,500,1167,1667
2025-05-29,A00614,INUKA 4WKS,500,1500,2000
2025-05-29,A00615,BIASHARA6W,334,633,967
2025-05-29,A00616,BIASHARA4W,250,150,400
2025-05-29,A00629,BIASHARA6W,334,834,1168
2025-05-29,A00630,INUKA 4WKS,500,1750,2250
2025-05-29,A00631,BIASHARA6W,334,834,1168
2025-05-29,A00632,BIASHARA6W,334,834,1168
2025-05-29,A00633,BIASHARA6W,336,834,1170
2025-05-29,A00634,INUKA6WKS,500,1167,1667
2025-05-29,A00635,BIASHARA6W,334,834,1168
2025-05-29,A00637,INUKA6WKS,500,1167,1667
2025-05-29,A00790,INUKA 4WKS,0,500,500
2025-05-30,A00012,BIASHARA6W,178,822,1000
2025-05-30,A00379,BIASHARA6W,306,494,800
2025-05-30,A00420,INUKA6WKS,500,1165,1665
2025-05-30,A00453,INUKA6WKS,500,500,1000
2025-05-30,A00455,BIASHARA6W,200,0,200
2025-05-30,A00488,INUKA6WKS,491,209,700
2025-05-30,A00495,INUKA6WKS,500,1167,1667
2025-05-30,A00514,BIASHARA6W,334,834,1168
2025-05-30,A00520,BIASHARA6W,16,302,318
2025-05-30,A00525,BIASHARA6W,0,418,418
2025-05-30,A00526,BIASHARA4W,250,1250,1500
2025-05-30,A00528,BIASHARA4W,0,300,300
2025-05-30,A00529,BIASHARA4W,250,1250,1500
2025-05-30,A00534,INUKA 4WKS,500,300,800
2025-05-30,A00536,INUKA6WKS,482,518,1000
2025-05-30,A00537,INUKA6WKS,500,1167,1667
2025-05-30,A00540,INUKA 4WKS,0,550,550
2025-05-30,A00543,INUKA6WKS,200,0,200
2025-05-30,A00546,INUKA 4WKS,1000,3000,4000
2025-05-30,A00563,BIASHARA6W,0,300,300
2025-05-30,A00575,BIASHARA4W,0,700,700
2025-05-30,A00579,BIASHARA6W,334,826,1160
2025-05-30,A00581,BIASHARA6W,0,568,568
2025-05-30,A00582,INUKA6WKS,500,1167,1667
2025-05-30,A00600,BIASHARA4W,0,1200,1200
2025-05-30,A00615,BIASHARA6W,0,201,201
2025-05-30,A00616,BIASHARA4W,0,1100,1100
2025-05-30,A00628,INUKA 4WKS,500,2000,2500
2025-05-30,A00640,BIASHARA4W,0,100,100
2025-05-30,A00672,BIASHARA4W,200,0,200
2025-05-30,A00675,INUKA6WKS,12,0,12
2025-05-30,A00676,INUKA6WKS,3,0,3
2025-05-30,A00678,BIASHARA4W,3,0,3
2025-05-30,A00934,BIASHARA6W,166,834,1000
2025-05-31,A00430,INUKA6WKS,500,1000,1500
2025-05-31,A00453,INUKA6WKS,0,667,667
2025-05-31,A00488,INUKA6WKS,0,820,820
2025-05-31,A00491,INUKA8WKS,500,75,575
2025-05-31,A00496,INUKA6WKS,1326,2334,3660
2025-05-31,A00525,BIASHARA6W,0,300,300
2025-05-31,A00528,BIASHARA4W,0,400,400
2025-05-31,A00536,INUKA6WKS,18,982,1000
2025-05-31,A00539,INUKA8WKS,500,875,1375
2025-05-31,A00563,BIASHARA6W,0,70,70
2025-05-31,A00580,INUKA 4WKS,500,1140,1640
2025-05-31,A00656,INUKA 4WKS,300,0,300
2025-05-31,A00672,BIASHARA4W,50,150,200
2025-06-01,A00076,BIASHARA4W,0,495,495
2025-06-01,A00397,BIASHARA4W,0,200,200
2025-06-01,A00412,INUKA6WKS,0,950,950
2025-06-01,A00488,INUKA6WKS,9,138,147
2025-06-01,A00491,INUKA8WKS,0,800,800
2025-06-01,A00541,BIASHARA6W,334,834,1168
2025-06-01,A00543,INUKA6WKS,50,250,300
2025-06-01,A00544,INUKA 4WKS,750,2250,3000
2025-06-01,A00554,BIASHARA4W,250,1250,1500
2025-06-01,A00556,BIASHARA6W,336,834,1170
2025-06-01,A00557,BIASHARA6W,336,834,1170
2025-06-01,A00594,INUKA6WKS,500,1167,1667
2025-06-01,A00598,BIASHARA4W,250,1250,1500
2025-06-01,A00599,BIASHARA6W,334,834,1168
2025-06-01,A00636,INUKA 4WKS,500,1750,2250
2025-06-01,A00640,BIASHARA4W,0,100,100
2025-06-01,A00641,BIASHARA4W,250,750,1000
2025-06-01,A00646,BIASHARA6W,334,464,798
2025-06-01,A00672,BIASHARA4W,0,200,200
2025-06-02,A00076,BIASHARA4W,0,200,200
2025-06-02,A00105,INUKA6WKS,500,500,1000
2025-06-02,A00360,BIASHARA4W,0,180,180
2025-06-02,A00430,INUKA6WKS,500,1000,1500
2025-06-02,A00459,INUKA6WKS,466,534,1000
2025-06-02,A00463,INUKA6WKS,401,999,1400
2025-06-02,A00465,BIASHARA4W,0,200,200
2025-06-02,A00466,BIASHARA6W,330,670,1000
2025-06-02,A00467,BIASHARA6W,330,770,1100
2025-06-02,A00505,BIASHARA6W,334,834,1168
2025-06-02,A00506,BIASHARA6W,334,166,500
2025-06-02,A00507,BIASHARA4W,250,1250,1500
2025-06-02,A00535,INUKA6WKS,185,15,200
2025-06-02,A00543,INUKA6WKS,0,917,917
2025-06-02,A00544,INUKA 4WKS,250,2250,2500
2025-06-02,A00545,INUKA 4WKS,1000,4000,5000
2025-06-02,A00551,BIASHARA6W,334,834,1168
2025-06-02,A00553,BIASHARA4W,250,1250,1500
2025-06-02,A00580,INUKA 4WKS,10,510,520
2025-06-02,A00584,BIASHARA4W,0,700,700
2025-06-02,A00585,INUKA6WKS,500,1667,2167
2025-06-02,A00587,INUKA 4WKS,500,1750,2250
2025-06-02,A00588,BIASHARA6W,334,306,640
2025-06-02,A00591,BIASHARA6W,332,236,568
2025-06-02,A00592,BIASHARA6W,366,834,1200
2025-06-02,A00607,BIASHARA4W,0,400,400
2025-06-02,A00638,BIASHARA4W,250,850,1100
2025-06-02,A00639,BIASHARA6W,334,334,668
2025-06-02,A00640,BIASHARA4W,0,800,800
2025-06-02,A00641,BIASHARA4W,0,460,460
2025-06-02,A00643,INUKA6WKS,500,1166,1666
2025-06-02,A00646,BIASHARA6W,0,364,364
2025-06-02,A00647,BIASHARA4W,250,1250,1500
2025-06-02,A00648,BIASHARA6W,334,566,900
2025-06-02,A00653,INUKA 4WKS,500,2000,2500
2025-06-02,A00655,INUKA6WKS,500,500,1000
2025-06-02,A00656,INUKA 4WKS,200,1750,1950
2025-06-02,A00672,BIASHARA4W,0,200,200
2025-06-02,A00684,BIASHARA6W,134,66,200
2025-06-02,A00690,INUKA6WKS,100,0,100
2025-06-02,A00934,BIASHARA6W,100,0,100
2025-06-03,A00088,INUKA6WKS,500,1500,2000
2025-06-03,A00105,INUKA6WKS,1000,2500,3500
2025-06-03,A00401,INUKA6WKS,0,200,200
2025-06-03,A00407,BIASHARA6W,0,400,400
2025-06-03,A00455,BIASHARA6W,117,83,200
2025-06-03,A00459,INUKA6WKS,40,800,840
2025-06-03,A00463,INUKA6WKS,101,168,269
2025-06-03,A00465,BIASHARA4W,0,200,200
2025-06-03,A00466,BIASHARA6W,334,994,1328
2025-06-03,A00470,INUKA6WKS,500,1000,1500
2025-06-03,A00472,INUKA6WKS,500,670,1170
2025-06-03,A00474,INUKA8WKS,500,1000,1500
2025-06-03,A00486,INUKA6WKS,503,1167,1670
2025-06-03,A00506,BIASHARA6W,668,2336,3004
2025-06-03,A00512,BIASHARA6W,334,234,568
2025-06-03,A00542,INUKA 4WKS,500,1750,2250
2025-06-03,A00555,BIASHARA4W,250,1250,1500
2025-06-03,A00558,INUKA 4WKS,500,500,1000
2025-06-03,A00560,INUKA6WKS,1994,3511,5505
2025-06-03,A00563,BIASHARA6W,334,834,1168
2025-06-03,A00564,BIASHARA6W,334,834,1168
2025-06-03,A00584,BIASHARA4W,250,550,800
2025-06-03,A00589,BIASHARA6W,334,266,600
2025-06-03,A00590,INUKA8WKS,500,0,500
2025-06-03,A00591,BIASHARA6W,2,598,600
2025-06-03,A00600,BIASHARA4W,250,400,650
2025-06-03,A00602,INUKA6WKS,500,200,700
2025-06-03,A00606,BIASHARA6W,334,834,1168
2025-06-03,A00608,INUKA6WKS,500,1000,1500
2025-06-03,A00638,BIASHARA4W,0,400,400
2025-06-03,A00641,BIASHARA4W,0,40,40
2025-06-03,A00642,INUKA 4WKS,500,2000,2500
2025-06-03,A00648,BIASHARA6W,0,268,268
2025-06-03,A00652,INUKA 4WKS,500,1750,2250
2025-06-03,A00654,INUKA6WKS,500,1167,1667
2025-06-03,A00657,INUKA8WKS,500,50,550
2025-06-03,A00658,INUKA6WKS,500,1334,1834
2025-06-03,A00659,BIASHARA6W,200,0,200
2025-06-03,A00660,INUKA 4WKS,500,2000,2500
2025-06-03,A00662,BIASHARA4W,250,350,600
2025-06-03,A00665,BIASHARA6W,334,834,1168
2025-06-03,A00672,BIASHARA4W,0,200,200
2025-06-03,A00673,BIASHARA6W,334,834,1168
2025-06-03,A00684,BIASHARA6W,200,0,200
2025-06-03,A00686,BIASHARA4W,250,1250,1500
2025-06-04,A00105,INUKA6WKS,0,410,410
2025-06-04,A00402,BIASHARA6W,84,716,800
2025-06-04,A00407,BIASHARA6W,0,200,200
2025-06-04,A00419,BIASHARA6W,162,830,992
2025-06-04,A00452,BIASHARA6W,334,830,1164
2025-06-04,A00469,INUKA6WKS,500,1167,1667
2025-06-04,A00470,INUKA6WKS,500,1000,1500
2025-06-04,A00472,INUKA6WKS,0,1000,1000
2025-06-04,A00480,BIASHARA6W,334,834,1168
2025-06-04,A00487,INUKA8WKS,500,875,1375
2025-06-04,A00488,INUKA6WKS,991,2334,3325
2025-06-04,A00503,INUKA6WKS,503,1667,2170
2025-06-04,A00512,BIASHARA6W,0,600,600
2025-06-04,A00513,BIASHARA6W,336,834,1170
2025-06-04,A00521,BIASHARA4W,250,1250,1500
2025-06-04,A00523,BIASHARA6W,336,834,1170
2025-06-04,A00542,INUKA 4WKS,500,1750,2250
2025-06-04,A00558,INUKA 4WKS,0,1250,1250
2025-06-04,A00563,BIASHARA6W,4,96,100
2025-06-04,A00565,BIASHARA4W,250,1250,1500
2025-06-04,A00572,BIASHARA4W,250,500,750
2025-06-04,A00573,BIASHARA6W,270,730,1000
2025-06-04,A00574,BIASHARA6W,310,190,500
2025-06-04,A00578,BIASHARA6W,334,834,1168
2025-06-04,A00588,BIASHARA6W,0,100,100
2025-06-04,A00589,BIASHARA6W,5,568,573
2025-06-04,A00590,INUKA8WKS,0,750,750
2025-06-04,A00593,INUKA6WKS,500,1750,2250
2025-06-04,A00598,BIASHARA4W,500,2500,3000
2025-06-04,A00602,INUKA6WKS,0,800,800
2025-06-04,A00611,INUKA 4WKS,500,1750,2250
2025-06-04,A00612,BIASHARA6W,336,834,1170
2025-06-04,A00657,INUKA8WKS,0,950,950
2025-06-04,A00659,BIASHARA6W,133,834,967
2025-06-04,A00662,BIASHARA4W,0,568,568
2025-06-04,A00663,INUKA6WKS,407,0,407
2025-06-04,A00666,INUKA6WKS,500,1167,1667
2025-06-04,A00671,BIASHARA6W,334,834,1168
2025-06-04,A00672,BIASHARA4W,0,300,300
2025-06-04,A00684,BIASHARA6W,0,200,200
2025-06-04,A00702,INUKA6WKS,31,0,31
2025-06-05,A00078,INUKA 4WKS,0,300,300
2025-06-05,A00150,BIASHARA6W,334,1357,1691
2025-06-05,A00267,BIASHARA4W,0,600,600
2025-06-05,A00360,BIASHARA4W,0,200,200
2025-06-05,A00453,INUKA6WKS,500,1165,1665
2025-06-05,A00458,INUKA6WKS,500,1665,2165
2025-06-05,A00459,INUKA6WKS,460,1330,1790
2025-06-05,A00465,BIASHARA4W,146,54,200
2025-06-05,A00498,BIASHARA6W,334,834,1168
2025-06-05,A00515,INUKA8WKS,525,875,1400
2025-06-05,A00520,BIASHARA6W,318,282,600
2025-06-05,A00522,BIASHARA6W,334,834,1168
2025-06-05,A00526,BIASHARA4W,250,1250,1500
2025-06-05,A00528,BIASHARA4W,250,250,500
2025-06-05,A00529,BIASHARA4W,250,1250,1500
2025-06-05,A00538,INUKA 4WKS,500,1750,2250
2025-06-05,A00566,INUKA 4WKS,500,1750,2250
2025-06-05,A00572,BIASHARA4W,0,750,750
2025-06-05,A00575,BIASHARA4W,250,1050,1300
2025-06-05,A00576,BIASHARA4W,250,450,700
2025-06-05,A00579,BIASHARA6W,334,834,1168
2025-06-05,A00582,INUKA6WKS,500,500,1000
2025-06-05,A00583,INUKA6WKS,500,1167,1667
2025-06-05,A00588,BIASHARA6W,0,428,428
2025-06-05,A00613,INUKA6WKS,500,1167,1667
2025-06-05,A00614,INUKA 4WKS,500,1500,2000
2025-06-05,A00629,BIASHARA6W,334,834,1168
2025-06-05,A00630,INUKA 4WKS,500,1750,2250
2025-06-05,A00634,INUKA6WKS,500,1167,1667
2025-06-05,A00635,BIASHARA6W,334,834,1168
2025-06-05,A00655,INUKA6WKS,0,667,667
2025-06-05,A00663,INUKA6WKS,93,1167,1260
2025-06-05,A00667,INUKA 4WKS,500,1500,2000
2025-06-05,A00672,BIASHARA4W,0,200,200
2025-06-05,A00674,BIASHARA6W,334,466,800
2025-06-05,A00683,BIASHARA6W,334,834,1168
2025-06-05,A00684,BIASHARA6W,2,568,570
2025-06-05,A00685,INUKA 4WKS,500,900,1400
2025-06-05,A00691,BIASHARA4W,250,230,480
2025-06-05,A00709,INUKA6WKS,92,0,92
2025-06-05,A00711,INUKA6WKS,2,0,2
2025-06-06,A00076,BIASHARA4W,250,50,300
2025-06-06,A00412,INUKA6WKS,500,500,1000
2025-06-06,A00467,BIASHARA6W,668,1732,2400
2025-06-06,A00472,INUKA6WKS,467,1665,2132
2025-06-06,A00474,INUKA8WKS,1500,3000,4500
2025-06-06,A00486,INUKA6WKS,503,1167,1670
2025-06-06,A00495,INUKA6WKS,997,2334,3331
2025-06-06,A00496,INUKA6WKS,78,722,800
2025-06-06,A00497,BIASHARA6W,334,834,1168
2025-06-06,A00514,BIASHARA6W,334,834,1168
2025-06-06,A00520,BIASHARA6W,0,258,258
2025-06-06,A00524,INUKA6WKS,503,1167,1670
2025-06-06,A00525,BIASHARA6W,334,834,1168
2025-06-06,A00534,INUKA 4WKS,500,3200,3700
2025-06-06,A00537,INUKA6WKS,500,1167,1667
2025-06-06,A00539,INUKA8WKS,500,875,1375
2025-06-06,A00543,INUKA6WKS,200,0,200
2025-06-06,A00573,BIASHARA6W,16,104,120
2025-06-06,A00574,BIASHARA6W,0,600,600
2025-06-06,A00575,BIASHARA4W,0,200,200
2025-06-06,A00581,BIASHARA6W,334,66,400
2025-06-06,A00582,INUKA6WKS,0,667,667
2025-06-06,A00600,BIASHARA4W,0,850,850
2025-06-06,A00610,BIASHARA4W,250,1250,1500
2025-06-06,A00615,BIASHARA6W,334,834,1168
2025-06-06,A00616,BIASHARA4W,250,1250,1500
2025-06-06,A00631,BIASHARA6W,334,834,1168
2025-06-06,A00632,BIASHARA6W,334,834,1168
2025-06-06,A00633,BIASHARA6W,366,834,1200
2025-06-06,A00637,INUKA6WKS,400,0,400
2025-06-06,A00662,BIASHARA4W,0,295,295
2025-06-06,A00672,BIASHARA4W,200,0,200
2025-06-06,A00674,BIASHARA6W,2,368,370
2025-06-06,A00675,INUKA6WKS,500,1167,1667
2025-06-06,A00678,BIASHARA4W,250,1250,1500
2025-06-06,A00684,BIASHARA6W,132,68,200
2025-06-06,A00685,INUKA 4WKS,0,850,850
2025-06-06,A00691,BIASHARA4W,0,250,250
2025-06-06,A00720,INUKA6WKS,36,0,36
2025-06-06,A00721,INUKA6WKS,1,0,1
2025-06-06,A00722,BIASHARA4W,6,0,6
2025-06-07,A00540,INUKA 4WKS,500,0,500
2025-06-07,A00543,INUKA6WKS,200,0,200
2025-06-07,A00576,BIASHARA4W,0,800,800
2025-06-07,A00580,INUKA 4WKS,490,407,897
2025-06-07,A00628,INUKA 4WKS,500,2000,2500
2025-06-07,A00637,INUKA6WKS,100,1160,1260
2025-06-07,A00640,BIASHARA4W,250,1250,1500
2025-06-07,A00662,BIASHARA4W,3,37,40
2025-06-07,A00667,INUKA 4WKS,0,500,500
2025-06-07,A00684,BIASHARA6W,200,0,200
2025-06-07,A00691,BIASHARA4W,0,400,400
2025-06-08,A00078,INUKA 4WKS,0,300,300
2025-06-08,A00097,INUKA6WKS,0,200,200
2025-06-08,A00496,INUKA6WKS,105,445,550
2025-06-08,A00541,BIASHARA6W,200,0,200
2025-06-08,A00543,INUKA6WKS,100,300,400
2025-06-08,A00554,BIASHARA4W,250,1250,1500
2025-06-08,A00555,BIASHARA4W,500,1500,2000
2025-06-08,A00556,BIASHARA6W,336,834,1170
2025-06-08,A00557,BIASHARA6W,336,834,1170
2025-06-08,A00580,INUKA 4WKS,0,203,203
2025-06-08,A00581,BIASHARA6W,0,400,400
2025-06-08,A00594,INUKA6WKS,500,700,1200
2025-06-08,A00599,BIASHARA6W,334,834,1168
2025-06-08,A00607,BIASHARA4W,0,500,500
2025-06-08,A00636,INUKA 4WKS,500,1750,2250
2025-06-08,A00637,INUKA6WKS,3,7,10
2025-06-08,A00641,BIASHARA4W,250,750,1000
2025-06-08,A00655,INUKA6WKS,500,1167,1667
2025-06-08,A00677,INUKA 4WKS,500,1750,2250
2025-06-08,A00690,INUKA6WKS,533,1167,1700
2025-06-08,A00691,BIASHARA4W,0,370,370
2025-06-08,A00719,INUKA6WKS,500,500,1000
2025-06-09,A00408,BIASHARA6W,334,156,490
2025-06-09,A00455,BIASHARA6W,0,280,280
2025-06-09,A00480,BIASHARA6W,334,830,1164
2025-06-09,A00491,INUKA8WKS,500,775,1275
2025-06-09,A00504,BIASHARA6W,100,0,100
2025-06-09,A00505,BIASHARA6W,334,356,690
2025-06-09,A00541,BIASHARA6W,134,830,964
2025-06-09,A00543,INUKA6WKS,0,867,867
2025-06-09,A00551,BIASHARA6W,334,834,1168
2025-06-09,A00553,BIASHARA4W,250,1250,1500
2025-06-09,A00555,BIASHARA4W,0,1000,1000
2025-06-09,A00558,INUKA 4WKS,500,1750,2250
2025-06-09,A00580,INUKA 4WKS,500,2890,3390
2025-06-09,A00584,BIASHARA4W,250,1250,1500
2025-06-09,A00585,INUKA6WKS,500,1667,2167
2025-06-09,A00587,INUKA 4WKS,500,1750,2250
2025-06-09,A00593,INUKA6WKS,832,1418,2250
2025-06-09,A00594,INUKA6WKS,0,467,467
2025-06-09,A00607,BIASHARA4W,0,250,250
2025-06-09,A00611,INUKA 4WKS,550,1750,2300
2025-06-09,A00639,BIASHARA6W,334,834,1168
2025-06-09,A00641,BIASHARA4W,0,500,500
2025-06-09,A00646,BIASHARA6W,334,838,1172
2025-06-09,A00647,BIASHARA4W,250,1250,1500
2025-06-09,A00656,INUKA 4WKS,500,1750,2250
2025-06-09,A00676,INUKA6WKS,497,503,1000
2025-06-09,A00684,BIASHARA6W,0,200,200
2025-06-09,A00687,BIASHARA4W,250,1250,1500
2025-06-09,A00688,INUKA 4WKS,500,2250,2750
2025-06-09,A00697,BIASHARA4W,250,1250,1500
2025-06-10,A00360,BIASHARA4W,0,180,180
2025-06-10,A00463,INUKA6WKS,393,1165,1558
2025-06-10,A00468,INUKA6WKS,500,1000,1500
2025-06-10,A00469,INUKA6WKS,460,1165,1625
2025-06-10,A00486,INUKA6WKS,491,1150,1641
2025-06-10,A00503,INUKA6WKS,503,1667,2170
2025-06-10,A00505,BIASHARA6W,0,478,478
2025-06-10,A00520,BIASHARA6W,16,294,310
2025-06-10,A00536,INUKA6WKS,482,518,1000
2025-06-10,A00560,INUKA6WKS,0,200,200
2025-06-10,A00563,BIASHARA6W,330,670,1000
2025-06-10,A00564,BIASHARA6W,1002,2502,3504
2025-06-10,A00565,BIASHARA4W,250,1250,1500
2025-06-10,A00566,INUKA 4WKS,500,1750,2250
2025-06-10,A00572,BIASHARA4W,250,1250,1500
2025-06-10,A00581,BIASHARA6W,0,368,368
2025-06-10,A00584,BIASHARA4W,250,1250,1500
2025-06-10,A00589,BIASHARA6W,329,371,700
2025-06-10,A00590,INUKA8WKS,500,750,1250
2025-06-10,A00591,BIASHARA6W,332,638,970
2025-06-10,A00602,INUKA6WKS,500,0,500
2025-06-10,A00606,BIASHARA6W,334,834,1168
2025-06-10,A00607,BIASHARA4W,150,100,250
2025-06-10,A00610,BIASHARA4W,250,750,1000
2025-06-10,A00611,INUKA 4WKS,450,1750,2200
2025-06-10,A00638,BIASHARA4W,250,1250,1500
2025-06-10,A00642,INUKA 4WKS,500,2000,2500
2025-06-10,A00643,INUKA6WKS,507,1168,1675
2025-06-10,A00648,BIASHARA6W,334,66,400
2025-06-10,A00652,INUKA 4WKS,500,900,1400
2025-06-10,A00653,INUKA 4WKS,500,1000,1500
2025-06-10,A00654,INUKA6WKS,500,500,1000
2025-06-10,A00658,INUKA6WKS,500,1334,1834
2025-06-10,A00660,INUKA 4WKS,500,2000,2500
2025-06-10,A00665,BIASHARA6W,334,834,1168
2025-06-10,A00676,INUKA6WKS,3,664,667
2025-06-10,A00689,INUKA 4WKS,500,500,1000
2025-06-10,A00693,BIASHARA6W,334,830,1164
2025-06-10,A00698,INUKA 4WKS,500,500,1000
2025-06-10,A00703,BIASHARA4W,250,1250,1500
2025-06-10,A00719,INUKA6WKS,0,600,600
2025-06-10,A00733,INUKA6WKS,500,1100,1600
2025-06-10,A00738,BIASHARA4W,8,0,8
2025-06-10,A00739,INUKA 4WKS,12,0,12
2025-06-10,A00741,BIASHARA6W,1,0,1
2025-06-10,A00745,INUKA6WKS,24,0,24
2025-06-11,A00012,BIASHARA6W,156,444,600
2025-06-11,A00465,BIASHARA4W,104,1246,1350
2025-06-11,A00503,INUKA6WKS,485,1665,2150
2025-06-11,A00512,BIASHARA6W,334,834,1168
2025-06-11,A00522,BIASHARA6W,666,1668,2334
2025-06-11,A00524,INUKA6WKS,500,1167,1667
2025-06-11,A00528,BIASHARA4W,0,500,500
2025-06-11,A00535,INUKA6WKS,0,500,500
2025-06-11,A00543,INUKA6WKS,250,0,250
2025-06-11,A00552,BIASHARA6W,426,1034,1460
2025-06-11,A00560,INUKA6WKS,0,911,911
2025-06-11,A00563,BIASHARA6W,6,164,170
2025-06-11,A00573,BIASHARA6W,318,482,800
2025-06-11,A00574,BIASHARA6W,334,266,600
2025-06-11,A00575,BIASHARA4W,250,350,600
2025-06-11,A00578,BIASHARA6W,334,834,1168
2025-06-11,A00579,BIASHARA6W,0,8,8
2025-06-11,A00589,BIASHARA6W,7,463,470
2025-06-11,A00591,BIASHARA6W,4,196,200
2025-06-11,A00592,BIASHARA6W,270,180,450
2025-06-11,A00602,INUKA6WKS,0,1000,1000
2025-06-11,A00608,INUKA6WKS,500,1000,1500
2025-06-11,A00612,BIASHARA6W,325,750,1075
2025-06-11,A00613,INUKA6WKS,500,1167,1667
2025-06-11,A00637,INUKA6WKS,833,1167,2000
2025-06-11,A00648,BIASHARA6W,0,200,200
2025-06-11,A00654,INUKA6WKS,0,667,667
2025-06-11,A00657,INUKA8WKS,500,1000,1500
2025-06-11,A00659,BIASHARA6W,329,271,600
2025-06-11,A00662,BIASHARA4W,247,633,880
2025-06-11,A00663,INUKA6WKS,500,1167,1667
2025-06-11,A00666,INUKA6WKS,500,1167,1667
2025-06-11,A00667,INUKA 4WKS,0,500,500
2025-06-11,A00671,BIASHARA6W,334,566,900
2025-06-11,A00672,BIASHARA4W,50,1050,1100
2025-06-11,A00673,BIASHARA6W,334,834,1168
2025-06-11,A00691,BIASHARA4W,200,0,200
2025-06-11,A00698,INUKA 4WKS,0,580,580
2025-06-11,A00699,INUKA 4WKS,500,1750,2250
2025-06-11,A00701,INUKA8WKS,500,1000,1500
2025-06-11,A00702,INUKA6WKS,503,1167,1670
2025-06-11,A00705,BIASHARA4W,250,1250,1500
2025-06-11,A00706,BIASHARA4W,250,1250,1500
2025-06-11,A00710,BIASHARA4W,250,1250,1500
2025-06-11,A00716,INUKA 4WKS,500,1750,2250
2025-06-11,A00717,BIASHARA4W,250,1000,1250
2025-06-11,A00718,INUKA 4WKS,500,100,600
2025-06-11,A00719,INUKA6WKS,0,67,67
2025-06-11,A00747,BIASHARA4W,250,150,400
2025-06-11,A00751,INUKA6WKS,36,0,36
2025-06-11,A00752,BIASHARA6W,2,0,2
2025-06-11,A00759,INUKA6WKS,109,0,109
2025-06-12,A00478,BIASHARA4W,0,250,250
2025-06-12,A00487,INUKA8WKS,500,875,1375
2025-06-12,A00491,INUKA8WKS,0,100,100
2025-06-12,A00496,INUKA6WKS,395,1165,1560
2025-06-12,A00498,BIASHARA6W,334,830,1164
2025-06-12,A00504,BIASHARA6W,32,268,300
2025-06-12,A00512,BIASHARA6W,334,830,1164
2025-06-12,A00513,BIASHARA6W,336,834,1170
2025-06-12,A00515,INUKA8WKS,525,875,1400
2025-06-12,A00520,BIASHARA6W,318,482,800
2025-06-12,A00523,BIASHARA6W,334,834,1168
2025-06-12,A00525,BIASHARA6W,334,834,1168
2025-06-12,A00536,INUKA6WKS,0,500,500
2025-06-12,A00539,INUKA8WKS,500,875,1375
2025-06-12,A00543,INUKA6WKS,200,0,200
2025-06-12,A00551,BIASHARA6W,250,0,250
2025-06-12,A00574,BIASHARA6W,0,570,570
2025-06-12,A00576,BIASHARA4W,250,1250,1500
2025-06-12,A00583,INUKA6WKS,425,542,967
2025-06-12,A00607,BIASHARA4W,100,150,250
2025-06-12,A00612,BIASHARA6W,50,45,95
2025-06-12,A00614,INUKA 4WKS,500,1500,2000
2025-06-12,A00629,BIASHARA6W,334,834,1168
2025-06-12,A00631,BIASHARA6W,334,816,1150
2025-06-12,A00632,BIASHARA6W,334,834,1168
2025-06-12,A00634,INUKA6WKS,500,1167,1667
2025-06-12,A00635,BIASHARA6W,334,834,1168
2025-06-12,A00652,INUKA 4WKS,0,850,850
2025-06-12,A00659,BIASHARA6W,5,563,568
2025-06-12,A00662,BIASHARA4W,0,40,40
2025-06-12,A00667,INUKA 4WKS,500,2100,2600
2025-06-12,A00674,BIASHARA6W,332,168,500
2025-06-12,A00685,INUKA 4WKS,500,1750,2250
2025-06-12,A00686,BIASHARA4W,250,1250,1500
2025-06-12,A00689,INUKA 4WKS,0,1000,1000
2025-06-12,A00691,BIASHARA4W,50,200,250
2025-06-12,A00698,INUKA 4WKS,0,650,650
2025-06-12,A00700,BIASHARA6W,334,162,496
2025-06-12,A00704,INUKA 4WKS,500,1500,2000
2025-06-12,A00707,BIASHARA4W,250,1250,1500
2025-06-12,A00708,BIASHARA6W,334,86,420
2025-06-12,A00709,INUKA6WKS,506,1334,1840
2025-06-12,A00717,BIASHARA4W,0,250,250
2025-06-12,A00718,INUKA 4WKS,0,1650,1650
2025-06-12,A00720,INUKA6WKS,464,406,870
2025-06-12,A00728,INUKA6WKS,500,1167,1667
2025-06-12,A00729,BIASHARA4W,250,1250,1500
2025-06-12,A00733,INUKA6WKS,3,67,70
2025-06-12,A00747,BIASHARA4W,0,500,500
2025-06-13,A00076,BIASHARA4W,0,200,200
2025-06-13,A00267,BIASHARA4W,0,200,200
2025-06-13,A00455,BIASHARA6W,0,100,100
2025-06-13,A00487,INUKA8WKS,1500,2625,4125
2025-06-13,A00491,INUKA8WKS,500,875,1375
2025-06-13,A00497,BIASHARA6W,334,830,1164
2025-06-13,A00514,BIASHARA6W,334,834,1168
2025-06-13,A00523,BIASHARA6W,330,830,1160
2025-06-13,A00528,BIASHARA4W,0,300,300
2025-06-13,A00535,INUKA6WKS,0,350,350
2025-06-13,A00536,INUKA6WKS,18,482,500
2025-06-13,A00537,INUKA6WKS,500,1167,1667
2025-06-13,A00540,INUKA 4WKS,500,3500,4000
2025-06-13,A00543,INUKA6WKS,11,189,200
2025-06-13,A00552,BIASHARA6W,242,48,290
2025-06-13,A00575,BIASHARA4W,0,700,700
2025-06-13,A00578,BIASHARA6W,668,1668,2336
2025-06-13,A00581,BIASHARA6W,326,74,400
2025-06-13,A00583,INUKA6WKS,1000,2959,3959
2025-06-13,A00588,BIASHARA6W,334,366,700
2025-06-13,A00607,BIASHARA4W,0,250,250
2025-06-13,A00610,BIASHARA4W,0,500,500
2025-06-13,A00615,BIASHARA6W,334,166,500
2025-06-13,A00616,BIASHARA4W,250,1250,1500
2025-06-13,A00630,INUKA 4WKS,300,0,300
2025-06-13,A00631,BIASHARA6W,0,18,18
2025-06-13,A00633,BIASHARA6W,336,834,1170
2025-06-13,A00648,BIASHARA6W,0,200,200
2025-06-13,A00662,BIASHARA4W,0,360,360
2025-06-13,A00667,INUKA 4WKS,0,400,400
2025-06-13,A00671,BIASHARA6W,0,268,268
2025-06-13,A00675,INUKA6WKS,500,1167,1667
2025-06-13,A00676,INUKA6WKS,497,503,1000
2025-06-13,A00677,INUKA 4WKS,500,1700,2200
2025-06-13,A00683,BIASHARA6W,334,156,490
2025-06-13,A00684,BIASHARA6W,4,566,570
2025-06-13,A00691,BIASHARA4W,0,350,350
2025-06-13,A00692,INUKA8WKS,37,0,37
2025-06-13,A00698,INUKA 4WKS,0,20,20
2025-06-13,A00700,BIASHARA6W,0,400,400
2025-06-13,A00708,BIASHARA6W,0,300,300
2025-06-13,A00711,INUKA6WKS,498,369,867
2025-06-13,A00720,INUKA6WKS,39,1261,1300
2025-06-13,A00721,INUKA6WKS,500,1167,1667
2025-06-13,A00722,BIASHARA4W,244,756,1000
2025-06-13,A00726,INUKA8WKS,500,500,1000
2025-06-13,A00730,INUKA 4WKS,500,1250,1750
2025-06-13,A00731,BIASHARA4W,250,1250,1500
2025-06-13,A00747,BIASHARA4W,0,200,200
2025-06-13,A00771,BIASHARA6W,0,6,6
2025-06-13,A00774,INUKA8WKS,32,0,32
2025-06-13,A00776,INUKA6WKS,73,0,73
2025-06-14,A00078,INUKA 4WKS,0,300,300
2025-06-14,A00520,BIASHARA6W,18,352,370
2025-06-14,A00528,BIASHARA4W,0,200,200
2025-06-14,A00543,INUKA6WKS,0,200,200
2025-06-14,A00573,BIASHARA6W,16,352,368
2025-06-14,A00588,BIASHARA6W,0,285,285
2025-06-14,A00615,BIASHARA6W,0,500,500
2025-06-14,A00677,INUKA 4WKS,0,30,30
2025-06-14,A00683,BIASHARA6W,0,570,570
2025-06-14,A00684,BIASHARA6W,30,220,250
2025-06-14,A00691,BIASHARA4W,0,140,140
2025-06-14,A00735,INUKA6WKS,501,1167,1668
2025-06-14,A00747,BIASHARA4W,0,400,400
2025-06-15,A00499,BIASHARA6W,200,0,200
2025-06-15,A00543,INUKA6WKS,0,200,200
2025-06-15,A00557,BIASHARA6W,635,1605,2240
2025-06-15,A00587,INUKA 4WKS,500,500,1000
2025-06-15,A00591,BIASHARA6W,292,308,600
2025-06-15,A00599,BIASHARA6W,334,834,1168
2025-06-15,A00607,BIASHARA4W,0,200,200
2025-06-15,A00628,INUKA 4WKS,500,700,1200
2025-06-15,A00640,BIASHARA4W,0,1000,1000
2025-06-15,A00674,BIASHARA6W,0,570,570
2025-06-15,A00676,INUKA6WKS,0,300,300
2025-06-15,A00678,BIASHARA4W,247,253,500
2025-06-15,A00684,BIASHARA6W,300,0,300
2025-06-15,A00690,INUKA6WKS,533,1167,1700
2025-06-15,A00691,BIASHARA4W,0,560,560
2025-06-15,A00700,BIASHARA6W,0,180,180
2025-06-15,A00726,INUKA8WKS,0,500,500
2025-06-16,A00360,BIASHARA4W,55,145,200
2025-06-16,A00455,BIASHARA6W,0,150,150
2025-06-16,A00478,BIASHARA4W,0,100,100
2025-06-16,A00505,BIASHARA6W,334,830,1164
2025-06-16,A00513,BIASHARA6W,324,830,1154
2025-06-16,A00514,BIASHARA6W,327,830,1157
2025-06-16,A00515,INUKA8WKS,625,875,1500
2025-06-16,A00536,INUKA6WKS,482,518,1000
2025-06-16,A00543,INUKA6WKS,39,578,617
2025-06-16,A00551,BIASHARA6W,418,1668,2086
2025-06-16,A00556,BIASHARA6W,635,1668,2303
2025-06-16,A00557,BIASHARA6W,0,59,59
2025-06-16,A00581,BIASHARA6W,8,760,768
2025-06-16,A00587,INUKA 4WKS,0,1250,1250
2025-06-16,A00591,BIASHARA6W,44,526,570
2025-06-16,A00593,INUKA6WKS,668,2082,2750
2025-06-16,A00594,INUKA6WKS,500,1167,1667
2025-06-16,A00600,BIASHARA4W,250,1250,1500
2025-06-16,A00615,BIASHARA6W,0,168,168
2025-06-16,A00616,BIASHARA4W,250,1250,1500
2025-06-16,A00628,INUKA 4WKS,132,1168,1300
2025-06-16,A00636,INUKA 4WKS,1000,3500,4500
2025-06-16,A00638,BIASHARA4W,250,1250,1500
2025-06-16,A00639,BIASHARA6W,334,834,1168
2025-06-16,A00640,BIASHARA4W,250,250,500
2025-06-16,A00642,INUKA 4WKS,500,2000,2500
2025-06-16,A00646,BIASHARA6W,334,834,1168
2025-06-16,A00647,BIASHARA4W,250,1250,1500
2025-06-16,A00648,BIASHARA6W,12,368,380
2025-06-16,A00653,INUKA 4WKS,50,950,1000
2025-06-16,A00656,INUKA 4WKS,500,1750,2250
2025-06-16,A00677,INUKA 4WKS,0,20,20
2025-06-16,A00683,BIASHARA6W,0,105,105
2025-06-16,A00684,BIASHARA6W,0,100,100
2025-06-16,A00687,BIASHARA4W,250,1250,1500
2025-06-16,A00688,INUKA 4WKS,500,2250,2750
2025-06-16,A00689,INUKA 4WKS,0,500,500
2025-06-16,A00693,BIASHARA6W,334,666,1000
2025-06-16,A00708,BIASHARA6W,0,400,400
2025-06-16,A00712,BIASHARA6W,334,834,1168
2025-06-16,A00722,BIASHARA4W,0,490,490
2025-06-16,A00732,INUKA6WKS,500,1500,2000
2025-06-16,A00736,INUKA6WKS,503,1167,1670
2025-06-16,A00740,BIASHARA4W,250,1250,1500
2025-06-16,A00741,BIASHARA6W,334,834,1168
2025-06-16,A00747,BIASHARA4W,250,750,1000
2025-06-16,A00780,BIASHARA6W,12,0,12
2025-06-16,A00782,BIASHARA6W,37,0,37
2025-06-16,A00787,BIASHARA4W,4,0,4
2025-06-16,A00795,BIASHARA6W,9,500,509
2025-06-17,A00408,BIASHARA6W,0,500,500
2025-06-17,A00478,BIASHARA4W,0,150,150
2025-06-17,A00499,BIASHARA6W,130,70,200
2025-06-17,A00536,INUKA6WKS,18,982,1000
2025-06-17,A00563,BIASHARA6W,662,1668,2330
2025-06-17,A00575,BIASHARA4W,0,200,200
2025-06-17,A00589,BIASHARA6W,336,834,1170
2025-06-17,A00590,INUKA8WKS,400,0,400
2025-06-17,A00600,BIASHARA4W,250,1250,1500
2025-06-17,A00606,BIASHARA6W,1002,2502,3504
2025-06-17,A00607,BIASHARA4W,0,250,250
2025-06-17,A00610,BIASHARA4W,250,1250,1500
2025-06-17,A00637,INUKA6WKS,1164,3501,4665
2025-06-17,A00641,BIASHARA4W,250,500,750
2025-06-17,A00643,INUKA6WKS,508,1167,1675
2025-06-17,A00648,BIASHARA6W,200,0,200
2025-06-17,A00652,INUKA 4WKS,500,1750,2250
2025-06-17,A00653,INUKA 4WKS,950,4000,4950
2025-06-17,A00654,INUKA6WKS,497,503,1000
2025-06-17,A00658,INUKA6WKS,500,1334,1834
2025-06-17,A00660,INUKA 4WKS,500,2000,2500
2025-06-17,A00665,BIASHARA6W,334,666,1000
2025-06-17,A00667,INUKA 4WKS,1000,5000,6000
2025-06-17,A00674,BIASHARA6W,4,96,100
2025-06-17,A00683,BIASHARA6W,0,3,3
2025-06-17,A00686,BIASHARA4W,250,1050,1300
2025-06-17,A00689,INUKA 4WKS,500,1700,2200
2025-06-17,A00693,BIASHARA6W,0,168,168
2025-06-17,A00697,BIASHARA4W,250,1250,1500
2025-06-17,A00703,BIASHARA4W,250,1250,1500
2025-06-17,A00710,BIASHARA4W,250,650,900
2025-06-17,A00711,INUKA6WKS,2,798,800
2025-06-17,A00731,BIASHARA4W,250,750,1000
2025-06-17,A00738,BIASHARA4W,250,1250,1500
2025-06-17,A00739,INUKA 4WKS,500,1750,2250
2025-06-17,A00748,INUKA 4WKS,500,1750,2250
2025-06-17,A00749,BIASHARA4W,250,1250,1500
2025-06-17,A00751,INUKA6WKS,464,706,1170
2025-06-17,A00761,BIASHARA4W,250,1250,1500
2025-06-17,A00762,INUKA6WKS,503,1167,1670
2025-06-17,A00763,INUKA6WKS,500,1167,1667
2025-06-17,A00764,BIASHARA4W,250,1250,1500
2025-06-17,A00769,INUKA6WKS,500,1160,1660
2025-06-17,A00789,INUKA6WKS,250,0,250
2025-06-17,A00790,INUKA 4WKS,0,500,500
2025-06-17,A00799,BIASHARA6W,53,0,53
2025-06-18,A00076,BIASHARA4W,0,100,100
2025-06-18,A00078,INUKA 4WKS,0,500,500
2025-06-18,A00360,BIASHARA4W,195,50,245
2025-06-18,A00478,BIASHARA4W,100,0,100
2025-06-18,A00499,BIASHARA6W,0,140,140
2025-06-18,A00536,INUKA6WKS,482,1500,1982
2025-06-18,A00543,INUKA6WKS,200,0,200
2025-06-18,A00573,BIASHARA6W,318,182,500
2025-06-18,A00574,BIASHARA6W,334,266,600
2025-06-18,A00579,BIASHARA6W,334,834,1168
2025-06-18,A00582,INUKA6WKS,500,1167,1667
2025-06-18,A00590,INUKA8WKS,40,460,500
2025-06-18,A00602,INUKA6WKS,500,1000,1500
2025-06-18,A00607,BIASHARA4W,0,200,200
2025-06-18,A00612,BIASHARA6W,341,834,1175
2025-06-18,A00613,INUKA6WKS,500,1167,1667
2025-06-18,A00640,BIASHARA4W,250,1250,1500
2025-06-18,A00642,INUKA 4WKS,500,2000,2500
2025-06-18,A00655,INUKA6WKS,500,667,1167
2025-06-18,A00662,BIASHARA4W,250,250,500
2025-06-18,A00663,INUKA6WKS,500,1167,1667
2025-06-18,A00665,BIASHARA6W,0,168,168
2025-06-18,A00671,BIASHARA6W,334,834,1168
2025-06-18,A00672,BIASHARA4W,250,1250,1500
2025-06-18,A00673,BIASHARA6W,334,834,1168
2025-06-18,A00678,BIASHARA4W,0,500,500
2025-06-18,A00690,INUKA6WKS,250,0,250
2025-06-18,A00691,BIASHARA4W,250,0,250
2025-06-18,A00692,INUKA8WKS,300,0,300
2025-06-18,A00698,INUKA 4WKS,500,1750,2250
2025-06-18,A00701,INUKA8WKS,500,1000,1500
2025-06-18,A00706,BIASHARA4W,250,450,700
2025-06-18,A00707,BIASHARA4W,250,500,750
2025-06-18,A00710,BIASHARA4W,0,600,600
2025-06-18,A00716,INUKA 4WKS,500,1750,2250
2025-06-18,A00718,INUKA 4WKS,500,345,845
2025-06-18,A00719,INUKA6WKS,503,1167,1670
2025-06-18,A00734,BIASHARA6W,334,834,1168
2025-06-18,A00750,INUKA8WKS,500,875,1375
2025-06-18,A00751,INUKA6WKS,39,961,1000
2025-06-18,A00752,BIASHARA6W,334,834,1168
2025-06-18,A00762,INUKA6WKS,350,0,350
2025-06-18,A00765,BIASHARA6W,334,166,500
2025-06-18,A00766,BIASHARA6W,334,834,1168
2025-06-18,A00768,BIASHARA6W,334,666,1000
2025-06-18,A00789,INUKA6WKS,250,0,250
2025-06-18,A00807,INUKA6WKS,18,0,18
2025-06-19,A00455,BIASHARA6W,0,150,150
2025-06-19,A00478,BIASHARA4W,100,0,100
2025-06-19,A00520,BIASHARA6W,316,484,800
2025-06-19,A00524,INUKA6WKS,497,1165,1662
2025-06-19,A00525,BIASHARA6W,334,666,1000
2025-06-19,A00537,INUKA6WKS,500,400,900
2025-06-19,A00539,INUKA8WKS,1500,2625,4125
2025-06-19,A00573,BIASHARA6W,0,200,200
2025-06-19,A00574,BIASHARA6W,0,500,500
2025-06-19,A00581,BIASHARA6W,334,834,1168
2025-06-19,A00607,BIASHARA4W,0,100,100
2025-06-19,A00608,INUKA6WKS,500,1000,1500
2025-06-19,A00614,INUKA 4WKS,500,1500,2000
2025-06-19,A00615,BIASHARA6W,334,366,700
2025-06-19,A00631,BIASHARA6W,334,834,1168
2025-06-19,A00632,BIASHARA6W,334,834,1168
2025-06-19,A00633,BIASHARA6W,966,2502,3468
2025-06-19,A00634,INUKA6WKS,500,1167,1667
2025-06-19,A00635,BIASHARA6W,334,834,1168
2025-06-19,A00641,BIASHARA4W,0,750,750
2025-06-19,A00648,BIASHARA6W,122,78,200
2025-06-19,A00655,INUKA6WKS,0,500,500
2025-06-19,A00659,BIASHARA6W,334,834,1168
2025-06-19,A00662,BIASHARA4W,250,2467,2717
2025-06-19,A00666,INUKA6WKS,500,1167,1667
2025-06-19,A00674,BIASHARA6W,330,570,900
2025-06-19,A00676,INUKA6WKS,3,364,367
2025-06-19,A00683,BIASHARA6W,334,566,900
2025-06-19,A00685,INUKA 4WKS,500,1750,2250
2025-06-19,A00686,BIASHARA4W,0,200,200
2025-06-19,A00690,INUKA6WKS,84,166,250
2025-06-19,A00691,BIASHARA4W,250,2500,2750
2025-06-19,A00692,INUKA8WKS,163,237,400
2025-06-19,A00699,INUKA 4WKS,500,1250,1750
2025-06-19,A00705,BIASHARA4W,250,1250,1500
2025-06-19,A00706,BIASHARA4W,0,800,800
2025-06-19,A00709,INUKA6WKS,506,1334,1840
2025-06-19,A00717,BIASHARA4W,250,1250,1500
2025-06-19,A00718,INUKA 4WKS,2,1405,1407
2025-06-19,A00726,INUKA8WKS,500,0,500
2025-06-19,A00728,INUKA6WKS,500,1167,1667
2025-06-19,A00729,BIASHARA4W,250,1250,1500
2025-06-19,A00733,INUKA6WKS,497,1103,1600
2025-06-19,A00768,BIASHARA6W,0,168,168
2025-06-19,A00769,INUKA6WKS,0,7,7
2025-06-19,A00771,BIASHARA6W,334,566,900
2025-06-19,A00772,INUKA6WKS,500,500,1000
2025-06-19,A00773,BIASHARA4W,250,1250,1500
2025-06-19,A00774,INUKA8WKS,500,407,907
2025-06-19,A00776,INUKA6WKS,427,673,1100
2025-06-19,A00778,BIASHARA6W,334,834,1168
2025-06-19,A00800,BIASHARA4W,200,0,200
2025-06-19,A00811,BIASHARA4W,0,500,500
2025-06-19,A00814,BIASHARA6W,33,0,33
2025-06-20,A00076,BIASHARA4W,0,300,300
2025-06-20,A00401,INUKA6WKS,0,200,200
2025-06-20,A00491,INUKA8WKS,495,605,1100
2025-06-20,A00520,BIASHARA6W,0,346,346
2025-06-20,A00525,BIASHARA6W,0,68,68
2025-06-20,A00537,INUKA6WKS,0,765,765
2025-06-20,A00543,INUKA6WKS,200,0,200
2025-06-20,A00579,BIASHARA6W,334,834,1168
2025-06-20,A00581,BIASHARA6W,326,830,1156
2025-06-20,A00590,INUKA8WKS,60,290,350
2025-06-20,A00613,INUKA6WKS,1000,2334,3334
2025-06-20,A00615,BIASHARA6W,0,268,268
2025-06-20,A00628,INUKA 4WKS,152,2132,2284
2025-06-20,A00629,BIASHARA6W,334,834,1168
2025-06-20,A00635,BIASHARA6W,668,1668,2336
2025-06-20,A00656,INUKA 4WKS,200,0,200
2025-06-20,A00657,INUKA8WKS,500,1000,1500
2025-06-20,A00675,INUKA6WKS,500,1167,1667
2025-06-20,A00676,INUKA6WKS,367,0,367
2025-06-20,A00677,INUKA 4WKS,500,1000,1500
2025-06-20,A00683,BIASHARA6W,0,115,115
2025-06-20,A00699,INUKA 4WKS,0,500,500
2025-06-20,A00700,BIASHARA6W,334,266,600
2025-06-20,A00707,BIASHARA4W,0,750,750
2025-06-20,A00711,INUKA6WKS,400,0,400
2025-06-20,A00720,INUKA6WKS,500,1667,2167
2025-06-20,A00721,INUKA6WKS,500,1167,1667
2025-06-20,A00722,BIASHARA4W,250,200,450
2025-06-20,A00726,INUKA8WKS,0,740,740
2025-06-20,A00727,INUKA 4WKS,500,1450,1950
2025-06-20,A00735,INUKA6WKS,500,1167,1667
2025-06-20,A00745,INUKA6WKS,476,524,1000
2025-06-20,A00765,BIASHARA6W,2,668,670
2025-06-20,A00767,BIASHARA6W,334,834,1168
2025-06-20,A00771,BIASHARA6W,10,262,272
2025-06-20,A00772,INUKA6WKS,0,667,667
2025-06-20,A00775,BIASHARA4W,250,918,1168
2025-06-20,A00776,INUKA6WKS,73,494,567
2025-06-20,A00828,BIASHARA6W,8,0,8
2025-06-21,A00455,BIASHARA6W,79,71,150
2025-06-21,A00491,INUKA8WKS,5,270,275
2025-06-21,A00525,BIASHARA6W,0,50,50
2025-06-21,A00543,INUKA6WKS,61,189,250
2025-06-21,A00607,BIASHARA4W,250,150,400
2025-06-21,A00630,INUKA 4WKS,200,100,300
2025-06-21,A00648,BIASHARA6W,0,405,405
2025-06-21,A00656,INUKA 4WKS,250,0,250
2025-06-21,A00684,BIASHARA6W,4,514,518
2025-06-21,A00722,BIASHARA4W,0,500,500
2025-06-21,A00726,INUKA8WKS,0,260,260
2025-06-21,A00800,BIASHARA4W,50,350,400
2025-06-21,A00832,BIASHARA4W,150,0,150
2025-06-22,A00468,INUKA6WKS,500,0,500
2025-06-22,A00543,INUKA6WKS,0,200,200
2025-06-22,A00591,BIASHARA6W,290,110,400
2025-06-22,A00594,INUKA6WKS,500,1167,1667
2025-06-22,A00599,BIASHARA6W,334,834,1168
2025-06-22,A00654,INUKA6WKS,0,400,400
2025-06-22,A00656,INUKA 4WKS,50,250,300
2025-06-22,A00687,BIASHARA4W,250,1250,1500
2025-06-22,A00690,INUKA6WKS,199,1001,1200
2025-06-22,A00700,BIASHARA6W,0,200,200
2025-06-22,A00722,BIASHARA4W,0,500,500
2025-06-22,A00731,BIASHARA4W,0,500,500
2025-06-22,A00733,INUKA6WKS,3,64,67
2025-06-22,A00747,BIASHARA4W,0,138,138
2025-06-22,A00782,BIASHARA6W,336,834,1170
2025-06-22,A00788,BIASHARA6W,334,834,1168
2025-06-22,A00789,INUKA6WKS,0,1000,1000
2025-06-23,A00078,INUKA 4WKS,500,1750,2250
2025-06-23,A00478,BIASHARA4W,50,50,100
2025-06-23,A00525,BIASHARA6W,0,46,46
2025-06-23,A00543,INUKA6WKS,0,500,500
2025-06-23,A00579,BIASHARA6W,52,148,200
2025-06-23,A00589,BIASHARA6W,100,0,100
2025-06-23,A00591,BIASHARA6W,0,400,400
2025-06-23,A00592,BIASHARA6W,0,200,200
2025-06-23,A00607,BIASHARA4W,0,440,440
2025-06-23,A00631,BIASHARA6W,668,1668,2336
2025-06-23,A00634,INUKA6WKS,1000,2334,3334
2025-06-23,A00638,BIASHARA4W,250,1250,1500
2025-06-23,A00639,BIASHARA6W,334,834,1168
2025-06-23,A00641,BIASHARA4W,250,1050,1300
2025-06-23,A00646,BIASHARA6W,364,836,1200
2025-06-23,A00647,BIASHARA4W,250,1250,1500
2025-06-23,A00648,BIASHARA6W,0,205,205
2025-06-23,A00656,INUKA 4WKS,0,1500,1500
2025-06-23,A00676,INUKA6WKS,130,70,200
2025-06-23,A00677,INUKA 4WKS,0,750,750
2025-06-23,A00683,BIASHARA6W,0,153,153
2025-06-23,A00684,BIASHARA6W,190,0,190
2025-06-23,A00687,BIASHARA4W,250,1250,1500
2025-06-23,A00688,INUKA 4WKS,1000,4500,5500
2025-06-23,A00689,INUKA 4WKS,1000,4300,5300
2025-06-23,A00692,INUKA8WKS,0,250,250
2025-06-23,A00693,BIASHARA6W,334,266,600
2025-06-23,A00700,BIASHARA6W,0,200,200
2025-06-23,A00703,BIASHARA4W,500,2500,3000
2025-06-23,A00708,BIASHARA6W,338,882,1220
2025-06-23,A00711,INUKA6WKS,100,1167,1267
2025-06-23,A00722,BIASHARA4W,0,50,50
2025-06-23,A00727,INUKA 4WKS,0,300,300
2025-06-23,A00736,INUKA6WKS,497,1003,1500
2025-06-23,A00740,BIASHARA4W,250,1250,1500
2025-06-23,A00747,BIASHARA4W,8,362,370
2025-06-23,A00749,BIASHARA4W,250,1250,1500
2025-06-23,A00759,INUKA6WKS,200,0,200
2025-06-23,A00775,BIASHARA4W,0,332,332
2025-06-23,A00779,INUKA 4WKS,500,1750,2250
2025-06-23,A00780,BIASHARA6W,336,834,1170
2025-06-23,A00781,BIASHARA4W,250,1250,1500
2025-06-23,A00783,BIASHARA6W,334,834,1168
2025-06-23,A00786,BIASHARA4W,250,1250,1500
2025-06-23,A00787,BIASHARA4W,250,1246,1496
2025-06-23,A00789,INUKA6WKS,0,167,167
2025-06-23,A00791,BIASHARA4W,250,1250,1500
2025-06-23,A00794,INUKA 4WKS,1000,2000,3000
2025-06-23,A00800,BIASHARA4W,0,100,100
2025-06-23,A00801,BIASHARA6W,334,834,1168
2025-06-23,A00802,BIASHARA4W,250,1250,1500
2025-06-24,A00078,INUKA 4WKS,0,50,50
2025-06-24,A00408,BIASHARA6W,222,278,500
2025-06-24,A00468,INUKA6WKS,0,500,500
2025-06-24,A00543,INUKA6WKS,0,276,276
2025-06-24,A00568,BIASHARA4W,250,250,500
2025-06-24,A00573,BIASHARA6W,16,452,468
2025-06-24,A00582,INUKA6WKS,833,1167,2000
2025-06-24,A00588,BIASHARA6W,334,701,1035
2025-06-24,A00589,BIASHARA6W,225,475,700
2025-06-24,A00591,BIASHARA6W,76,324,400
2025-06-24,A00612,BIASHARA6W,341,834,1175
2025-06-24,A00615,BIASHARA6W,0,200,200
2025-06-24,A00641,BIASHARA4W,0,200,200
2025-06-24,A00652,INUKA 4WKS,500,1750,2250
2025-06-24,A00654,INUKA6WKS,36,264,300
2025-06-24,A00655,INUKA6WKS,500,1167,1667
2025-06-24,A00660,INUKA 4WKS,500,2000,2500
2025-06-24,A00663,INUKA6WKS,500,500,1000
2025-06-24,A00665,BIASHARA6W,334,366,700
2025-06-24,A00672,BIASHARA4W,250,1450,1700
2025-06-24,A00685,INUKA 4WKS,500,1750,2250
2025-06-24,A00692,INUKA8WKS,152,638,790
2025-06-24,A00697,BIASHARA4W,500,2500,3000
2025-06-24,A00698,INUKA 4WKS,1000,3500,4500
2025-06-24,A00708,BIASHARA6W,200,0,200
2025-06-24,A00710,BIASHARA4W,250,350,600
2025-06-24,A00732,INUKA6WKS,500,500,1000
2025-06-24,A00736,INUKA6WKS,6,164,170
2025-06-24,A00738,BIASHARA4W,250,1250,1500
2025-06-24,A00739,INUKA 4WKS,500,1750,2250
2025-06-24,A00741,BIASHARA6W,334,834,1168
2025-06-24,A00745,INUKA6WKS,24,643,667
2025-06-24,A00748,INUKA 4WKS,500,1750,2250
2025-06-24,A00751,INUKA6WKS,503,1667,2170
2025-06-24,A00752,BIASHARA6W,334,834,1168
2025-06-24,A00761,BIASHARA4W,250,1250,1500
2025-06-24,A00762,INUKA6WKS,153,1167,1320
2025-06-24,A00764,BIASHARA4W,250,1250,1500
2025-06-24,A00790,INUKA 4WKS,500,2000,2500
2025-06-24,A00792,BIASHARA4W,250,450,700
2025-06-24,A00793,BIASHARA6W,334,834,1168
2025-06-24,A00795,BIASHARA6W,334,334,668
2025-06-24,A00800,BIASHARA4W,0,800,800
2025-06-24,A00802,BIASHARA4W,100,0,100
2025-06-24,A00806,INUKA 4WKS,500,500,1000
2025-06-24,A00807,INUKA6WKS,500,1500,2000
2025-06-24,A00868,BIASHARA6W,18,0,18
2025-06-25,A00076,BIASHARA4W,0,200,200
2025-06-25,A00499,BIASHARA6W,0,200,200
2025-06-25,A00515,INUKA8WKS,750,1750,2500
2025-06-25,A00574,BIASHARA6W,334,944,1278
2025-06-25,A00582,INUKA6WKS,167,1165,1332
2025-06-25,A00585,INUKA6WKS,1500,5003,6503
2025-06-25,A00589,BIASHARA6W,0,220,220
2025-06-25,A00590,INUKA8WKS,440,510,950
2025-06-25,A00591,BIASHARA6W,258,830,1088
2025-06-25,A00592,BIASHARA6W,0,210,210
2025-06-25,A00599,BIASHARA6W,334,830,1164
2025-06-25,A00602,INUKA6WKS,500,1000,1500
2025-06-25,A00612,BIASHARA6W,270,830,1100
2025-06-25,A00632,BIASHARA6W,50,0,50
2025-06-25,A00643,INUKA6WKS,500,1167,1667
2025-06-25,A00655,INUKA6WKS,1000,2334,3334
2025-06-25,A00658,INUKA6WKS,500,1334,1834
2025-06-25,A00659,BIASHARA6W,250,0,250
2025-06-25,A00663,INUKA6WKS,0,467,467
2025-06-25,A00665,BIASHARA6W,0,468,468
2025-06-25,A00666,INUKA6WKS,500,767,1267
2025-06-25,A00673,BIASHARA6W,334,834,1168
2025-06-25,A00674,BIASHARA6W,6,264,270
2025-06-25,A00676,INUKA6WKS,0,400,400
2025-06-25,A00686,BIASHARA4W,250,650,900
2025-06-25,A00699,INUKA 4WKS,500,0,500
2025-06-25,A00701,INUKA8WKS,500,1000,1500
2025-06-25,A00704,INUKA 4WKS,500,500,1000
2025-06-25,A00706,BIASHARA4W,250,1250,1500
2025-06-25,A00707,BIASHARA4W,250,500,750
2025-06-25,A00710,BIASHARA4W,0,900,900
2025-06-25,A00712,BIASHARA6W,334,834,1168
2025-06-25,A00716,INUKA 4WKS,500,1750,2250
2025-06-25,A00718,INUKA 4WKS,498,222,720
2025-06-25,A00719,INUKA6WKS,503,1167,1670
2025-06-25,A00727,INUKA 4WKS,500,1700,2200
2025-06-25,A00732,INUKA6WKS,0,600,600
2025-06-25,A00747,BIASHARA4W,242,458,700
2025-06-25,A00765,BIASHARA6W,332,468,800
2025-06-25,A00766,BIASHARA6W,334,834,1168
2025-06-25,A00768,BIASHARA6W,334,666,1000
2025-06-25,A00769,INUKA6WKS,500,300,800
2025-06-25,A00775,BIASHARA4W,250,1250,1500
2025-06-25,A00790,INUKA 4WKS,0,500,500
2025-06-25,A00799,BIASHARA6W,281,19,300
2025-06-25,A00802,BIASHARA4W,100,0,100
2025-06-25,A00806,INUKA 4WKS,0,2000,2000
2025-06-25,A00810,BIASHARA6W,334,834,1168
2025-06-25,A00814,BIASHARA6W,336,834,1170
2025-06-25,A00816,BIASHARA4W,250,1250,1500
2025-06-25,A00863,INUKA6WKS,4,0,4
2025-06-25,A00871,BIASHARA6W,48,0,48
2025-06-25,A00875,BIASHARA6W,66,0,66
2025-06-26,A00478,BIASHARA4W,0,1200,1200
2025-06-26,A00491,INUKA8WKS,495,875,1370
2025-06-26,A00535,INUKA6WKS,115,135,250
2025-06-26,A00579,BIASHARA6W,0,682,682
2025-06-26,A00590,INUKA8WKS,0,150,150
2025-06-26,A00592,BIASHARA6W,107,238,345
2025-06-26,A00608,INUKA6WKS,300,0,300
2025-06-26,A00615,BIASHARA6W,334,166,500
2025-06-26,A00632,BIASHARA6W,0,614,614
2025-06-26,A00654,INUKA6WKS,267,0,267
2025-06-26,A00657,INUKA8WKS,500,1000,1500
2025-06-26,A00659,BIASHARA6W,79,806,885
2025-06-26,A00663,INUKA6WKS,0,200,200
2025-06-26,A00666,INUKA6WKS,0,400,400
2025-06-26,A00674,BIASHARA6W,328,372,700
2025-06-26,A00677,INUKA 4WKS,500,1750,2250
2025-06-26,A00684,BIASHARA6W,140,40,180
2025-06-26,A00686,BIASHARA4W,0,600,600
2025-06-26,A00699,INUKA 4WKS,0,1100,1100
2025-06-26,A00705,BIASHARA4W,250,1250,1500
2025-06-26,A00707,BIASHARA4W,0,750,750
2025-06-26,A00709,INUKA6WKS,506,1334,1840
2025-06-26,A00717,BIASHARA4W,250,450,700
2025-06-26,A00726,INUKA8WKS,500,100,600
2025-06-26,A00728,INUKA6WKS,500,1167,1667
2025-06-26,A00729,BIASHARA4W,250,1250,1500
2025-06-26,A00734,BIASHARA6W,334,834,1168
2025-06-26,A00740,BIASHARA4W,500,2500,3000
2025-06-26,A00745,INUKA6WKS,503,1167,1670
2025-06-26,A00750,INUKA8WKS,500,0,500
2025-06-26,A00763,INUKA6WKS,533,1167,1700
2025-06-26,A00765,BIASHARA6W,2,366,368
2025-06-26,A00767,BIASHARA6W,334,834,1168
2025-06-26,A00768,BIASHARA6W,0,168,168
2025-06-26,A00769,INUKA6WKS,0,867,867
2025-06-26,A00771,BIASHARA6W,333,834,1167
2025-06-26,A00776,INUKA6WKS,427,473,900
2025-06-26,A00778,BIASHARA6W,334,834,1168
2025-06-26,A00792,BIASHARA4W,0,800,800
2025-06-26,A00796,BIASHARA4W,250,1250,1500
2025-06-26,A00802,BIASHARA4W,50,950,1000
2025-06-26,A00805,INUKA 4WKS,500,1750,2250
2025-06-26,A00809,BIASHARA6W,334,834,1168
2025-06-26,A00811,BIASHARA4W,250,250,500
2025-06-26,A00817,INUKA8WKS,500,875,1375
2025-06-26,A00818,INUKA6WKS,400,0,400
2025-06-26,A00821,BIASHARA6W,334,566,900
2025-06-26,A00827,BIASHARA4W,250,750,1000
2025-06-26,A00831,BIASHARA4W,250,1250,1500
2025-06-26,A00832,BIASHARA4W,100,0,100
2025-06-26,A00833,BIASHARA6W,334,834,1168
2025-06-26,A00834,BIASHARA6W,334,834,1168
2025-06-26,A00934,BIASHARA6W,145,55,200
2025-06-27,A00132,BIASHARA4W,0,1000,1000
2025-06-27,A00607,BIASHARA4W,0,250,250
2025-06-27,A00615,BIASHARA6W,334,1498,1832
2025-06-27,A00659,BIASHARA6W,7,28,35
2025-06-27,A00663,INUKA6WKS,1000,2334,3334
2025-06-27,A00675,INUKA6WKS,500,1167,1667
2025-06-27,A00676,INUKA6WKS,0,600,600
2025-06-27,A00692,INUKA8WKS,348,152,500
2025-06-27,A00693,BIASHARA6W,0,200,200
2025-06-27,A00699,INUKA 4WKS,0,650,650
2025-06-27,A00710,BIASHARA4W,250,1250,1500
2025-06-27,A00717,BIASHARA4W,0,800,800
2025-06-27,A00721,INUKA6WKS,500,1167,1667
2025-06-27,A00722,BIASHARA4W,250,250,500
2025-06-27,A00726,INUKA8WKS,0,900,900
2025-06-27,A00730,INUKA 4WKS,500,750,1250
2025-06-27,A00772,INUKA6WKS,500,0,500
2025-06-27,A00773,BIASHARA4W,250,550,800
2025-06-27,A00776,INUKA6WKS,0,667,667
2025-06-27,A00812,INUKA 4WKS,500,1500,2000
2025-06-27,A00813,BIASHARA4W,250,1033,1283
2025-06-27,A00818,INUKA6WKS,100,1167,1267
2025-06-27,A00819,INUKA6WKS,500,1267,1767
2025-06-27,A00821,BIASHARA6W,0,180,180
2025-06-27,A00827,BIASHARA4W,0,500,500
2025-06-27,A00828,BIASHARA6W,326,274,600
2025-06-27,A00830,INUKA6WKS,503,1167,1670
2025-06-27,A00832,BIASHARA4W,0,250,250
2025-06-28,A00468,INUKA6WKS,0,150,150
2025-06-28,A00499,BIASHARA6W,0,200,200
2025-06-28,A00588,BIASHARA6W,334,1150,1484
2025-06-28,A00589,BIASHARA6W,11,139,150
2025-06-28,A00590,INUKA8WKS,60,90,150
2025-06-28,A00592,BIASHARA6W,227,43,270
2025-06-28,A00608,INUKA6WKS,200,1000,1200
2025-06-28,A00684,BIASHARA6W,0,400,400
2025-06-28,A00690,INUKA6WKS,533,1167,1700
2025-06-28,A00720,INUKA6WKS,493,1667,2160
2025-06-28,A00727,INUKA 4WKS,0,50,50
2025-06-28,A00731,BIASHARA4W,250,1250,1500
2025-06-28,A00732,INUKA6WKS,0,400,400
2025-06-28,A00733,INUKA6WKS,500,1167,1667
2025-06-28,A00759,INUKA6WKS,191,309,500
2025-06-28,A00776,INUKA6WKS,73,27,100
2025-06-28,A00811,BIASHARA4W,0,500,500
2025-06-28,A00820,INUKA6WKS,500,1167,1667
2025-06-28,A00821,BIASHARA6W,0,88,88
2025-06-28,A00832,BIASHARA4W,0,390,390
2025-06-28,A00871,BIASHARA6W,286,14,300
2025-06-29,A00592,BIASHARA6W,0,160,160
2025-06-29,A00594,INUKA6WKS,500,100,600
2025-06-29,A00607,BIASHARA4W,0,200,200
2025-06-29,A00629,BIASHARA6W,334,834,1168
2025-06-29,A00683,BIASHARA6W,334,834,1168
2025-06-29,A00700,BIASHARA6W,0,240,240
2025-06-29,A00735,INUKA6WKS,499,701,1200
2025-06-29,A00750,INUKA8WKS,0,300,300
2025-06-29,A00782,BIASHARA6W,336,834,1170
2025-06-29,A00786,BIASHARA4W,250,850,1100
2025-06-29,A00787,BIASHARA4W,250,1250,1500
2025-06-29,A00788,BIASHARA6W,334,834,1168
2025-06-29,A00789,INUKA6WKS,500,1000,1500
2025-06-29,A00832,BIASHARA4W,0,300,300
2025-06-29,A00835,BIASHARA4W,250,1250,1500
2025-06-29,A00837,BIASHARA4W,250,1250,1500
2025-06-29,A00842,BIASHARA6W,334,834,1168
2025-06-29,A00848,INUKA 4WKS,500,1750,2250
2025-06-29,A00850,BIASHARA4W,250,1250,1500
2025-06-29,A00851,INUKA8WKS,500,750,1250
2025-06-29,A00858,INUKA 4WKS,500,100,600
2025-06-29,A00871,BIASHARA6W,0,500,500
2025-06-30,A00573,BIASHARA6W,318,182,500
2025-06-30,A00592,BIASHARA6W,0,267,267
2025-06-30,A00594,INUKA6WKS,0,1065,1065
2025-06-30,A00630,INUKA 4WKS,0,1000,1000
2025-06-30,A00632,BIASHARA6W,618,1050,1668
2025-06-30,A00639,BIASHARA6W,668,2168,2836
2025-06-30,A00646,BIASHARA6W,330,834,1164
2025-06-30,A00674,BIASHARA6W,0,300,300
2025-06-30,A00692,INUKA8WKS,0,810,810
2025-06-30,A00693,BIASHARA6W,128,372,500
2025-06-30,A00700,BIASHARA6W,210,20,230
2025-06-30,A00704,INUKA 4WKS,0,1000,1000
2025-06-30,A00708,BIASHARA6W,136,834,970
2025-06-30,A00718,INUKA 4WKS,2,1528,1530
2025-06-30,A00729,BIASHARA4W,250,1250,1500
2025-06-30,A00730,INUKA 4WKS,0,1000,1000
2025-06-30,A00736,INUKA6WKS,503,1167,1670
2025-06-30,A00739,INUKA 4WKS,500,1750,2250
2025-06-30,A00741,BIASHARA6W,333,707,1040
2025-06-30,A00759,INUKA6WKS,0,500,500
2025-06-30,A00773,BIASHARA4W,0,700,700
2025-06-30,A00779,INUKA 4WKS,500,1750,2250
2025-06-30,A00780,BIASHARA6W,336,834,1170
2025-06-30,A00781,BIASHARA4W,250,1250,1500
2025-06-30,A00783,BIASHARA6W,334,766,1100
2025-06-30,A00786,BIASHARA4W,0,400,400
2025-06-30,A00789,INUKA6WKS,0,167,167
2025-06-30,A00800,BIASHARA4W,250,550,800
2025-06-30,A00801,BIASHARA6W,334,834,1168
2025-06-30,A00802,BIASHARA4W,0,200,200
2025-06-30,A00814,BIASHARA6W,334,834,1168
2025-06-30,A00828,BIASHARA6W,0,300,300
2025-06-30,A00832,BIASHARA4W,0,150,150
2025-06-30,A00836,INUKA 4WKS,500,1500,2000
2025-06-30,A00840,INUKA 4WKS,500,1500,2000
2025-06-30,A00849,BIASHARA4W,250,1250,1500
2025-06-30,A00852,BIASHARA6W,334,834,1168
2025-06-30,A00861,BIASHARA4W,250,1250,1500
2025-06-30,A00865,INUKA8WKS,525,875,1400
2025-06-30,A00875,BIASHARA6W,341,834,1175
2025-07-01,A00076,BIASHARA4W,0,100,100
2025-07-01,A00408,BIASHARA6W,166,834,1000
2025-07-01,A00455,BIASHARA6W,130,0,130
2025-07-01,A00499,BIASHARA6W,0,200,200
2025-07-01,A00589,BIASHARA6W,323,577,900
2025-07-01,A00590,INUKA8WKS,400,0,400
2025-07-01,A00602,INUKA6WKS,300,0,300
2025-07-01,A00607,BIASHARA4W,0,200,200
2025-07-01,A00608,INUKA6WKS,500,1000,1500
2025-07-01,A00643,INUKA6WKS,400,0,400
2025-07-01,A00657,INUKA8WKS,500,0,500
2025-07-01,A00665,BIASHARA6W,334,166,500
2025-07-01,A00690,INUKA6WKS,768,2334,3102
2025-07-01,A00692,INUKA8WKS,162,163,325
2025-07-01,A00700,BIASHARA6W,124,76,200
2025-07-01,A00717,BIASHARA4W,250,1250,1500
2025-07-01,A00720,INUKA6WKS,7,0,7
2025-07-01,A00727,INUKA 4WKS,500,100,600
2025-07-01,A00731,BIASHARA4W,250,750,1000
2025-07-01,A00734,BIASHARA6W,334,666,1000
2025-07-01,A00735,INUKA6WKS,1,466,467
2025-07-01,A00738,BIASHARA4W,250,1250,1500
2025-07-01,A00739,INUKA 4WKS,488,1750,2238
2025-07-01,A00741,BIASHARA6W,1,127,128
2025-07-01,A00747,BIASHARA4W,8,792,800
2025-07-01,A00751,INUKA6WKS,503,1667,2170
2025-07-01,A00762,INUKA6WKS,494,1166,1660
2025-07-01,A00764,BIASHARA4W,500,2500,3000
2025-07-01,A00783,BIASHARA6W,0,68,68
2025-07-01,A00791,BIASHARA4W,250,1250,1500
2025-07-01,A00793,BIASHARA6W,334,356,690
2025-07-01,A00794,INUKA 4WKS,1000,5000,6000
2025-07-01,A00800,BIASHARA4W,0,498,498
2025-07-01,A00802,BIASHARA4W,0,100,100
2025-07-01,A00832,BIASHARA4W,0,160,160
2025-07-01,A00836,INUKA 4WKS,0,750,750
2025-07-01,A00840,INUKA 4WKS,0,500,500
2025-07-01,A00854,BIASHARA4W,250,1250,1500
2025-07-01,A00855,INUKA 4WKS,500,1750,2250
2025-07-01,A00856,BIASHARA4W,250,1250,1500
2025-07-01,A00857,BIASHARA4W,250,1250,1500
2025-07-01,A00858,INUKA 4WKS,0,1650,1650
2025-07-01,A00862,BIASHARA6W,334,831,1165
2025-07-01,A00864,INUKA 4WKS,500,2000,2500
2025-07-01,A00869,BIASHARA4W,250,1250,1500
2025-07-01,A00871,BIASHARA6W,50,320,370
2025-07-01,A00872,INUKA 4WKS,500,1750,2250
2025-07-01,A00877,BIASHARA4W,250,1250,1500
2025-07-01,A00884,BIASHARA4W,250,1150,1400
2025-07-01,A00888,BIASHARA6W,334,166,500
2025-07-02,A00468,INUKA6WKS,0,350,350
2025-07-02,A00504,BIASHARA6W,600,1400,2000
2025-07-02,A00588,BIASHARA6W,334,830,1164
2025-07-02,A00589,BIASHARA6W,0,100,100
2025-07-02,A00590,INUKA8WKS,100,750,850
2025-07-02,A00592,BIASHARA6W,0,150,150
2025-07-02,A00602,INUKA6WKS,200,1000,1200
2025-07-02,A00643,INUKA6WKS,103,1167,1270
2025-07-02,A00659,BIASHARA6W,334,834,1168
2025-07-02,A00665,BIASHARA6W,0,668,668
2025-07-02,A00673,BIASHARA6W,334,834,1168
2025-07-02,A00674,BIASHARA6W,6,162,168
2025-07-02,A00692,INUKA8WKS,200,0,200
2025-07-02,A00699,INUKA 4WKS,500,1750,2250
2025-07-02,A00701,INUKA8WKS,500,500,1000
2025-07-02,A00706,BIASHARA4W,250,1250,1500
2025-07-02,A00707,BIASHARA4W,250,1250,1500
2025-07-02,A00709,INUKA6WKS,390,610,1000
2025-07-02,A00716,INUKA 4WKS,500,1750,2250
2025-07-02,A00718,INUKA 4WKS,498,1750,2248
2025-07-02,A00719,INUKA6WKS,503,1167,1670
2025-07-02,A00732,INUKA6WKS,500,1500,2000
2025-07-02,A00748,INUKA 4WKS,500,1750,2250
2025-07-02,A00752,BIASHARA6W,334,834,1168
2025-07-02,A00761,BIASHARA4W,250,1250,1500
2025-07-02,A00762,INUKA6WKS,0,1,1
2025-07-02,A00763,INUKA6WKS,500,1167,1667
2025-07-02,A00766,BIASHARA6W,334,834,1168
2025-07-02,A00768,BIASHARA6W,334,666,1000
2025-07-02,A00795,BIASHARA6W,334,834,1168
2025-07-02,A00799,BIASHARA6W,651,1649,2300
2025-07-02,A00800,BIASHARA4W,0,200,200
2025-07-02,A00806,INUKA 4WKS,500,2500,3000
2025-07-02,A00807,INUKA6WKS,500,500,1000
2025-07-02,A00816,BIASHARA4W,250,750,1000
2025-07-02,A00832,BIASHARA4W,200,0,200
2025-07-02,A00841,INUKA6WKS,500,567,1067
2025-07-02,A00852,BIASHARA6W,334,834,1168
2025-07-02,A00853,BIASHARA4W,250,1250,1500
2025-07-02,A00862,BIASHARA6W,0,3,3
2025-07-02,A00866,BIASHARA4W,250,1150,1400
2025-07-02,A00882,BIASHARA6W,334,834,1168
2025-07-02,A00900,INUKA6WKS,100,0,100
2025-07-03,A00012,BIASHARA6W,0,386,386
2025-07-03,A00360,BIASHARA4W,0,200,200
2025-07-03,A00455,BIASHARA6W,125,10,135
2025-07-03,A00499,BIASHARA6W,176,24,200
2025-07-03,A00504,BIASHARA6W,68,132,200
2025-07-03,A00509,BIASHARA6W,334,1474,1808
2025-07-03,A00589,BIASHARA6W,0,153,153
2025-07-03,A00629,BIASHARA6W,334,830,1164
2025-07-03,A00654,INUKA6WKS,197,303,500
2025-07-03,A00657,INUKA8WKS,0,500,500
2025-07-03,A00659,BIASHARA6W,327,830,1157
2025-07-03,A00666,INUKA6WKS,500,1167,1667
2025-07-03,A00692,INUKA8WKS,138,562,700
2025-07-03,A00693,BIASHARA6W,206,94,300
2025-07-03,A00701,INUKA8WKS,0,500,500
2025-07-03,A00705,BIASHARA4W,250,1250,1500
2025-07-03,A00709,INUKA6WKS,106,724,830
2025-07-03,A00726,INUKA8WKS,500,200,700
2025-07-03,A00727,INUKA 4WKS,0,925,925
2025-07-03,A00730,INUKA 4WKS,500,500,1000
2025-07-03,A00749,BIASHARA4W,250,1250,1500
2025-07-03,A00765,BIASHARA6W,334,834,1168
2025-07-03,A00768,BIASHARA6W,0,168,168
2025-07-03,A00774,INUKA8WKS,500,875,1375
2025-07-03,A00775,BIASHARA4W,250,1250,1500
2025-07-03,A00778,BIASHARA6W,334,834,1168
2025-07-03,A00807,INUKA6WKS,0,1000,1000
2025-07-03,A00809,BIASHARA6W,334,834,1168
2025-07-03,A00810,BIASHARA6W,334,834,1168
2025-07-03,A00816,BIASHARA4W,0,500,500
2025-07-03,A00817,INUKA8WKS,500,875,1375
2025-07-03,A00820,INUKA6WKS,500,1167,1667
2025-07-03,A00827,BIASHARA4W,250,750,1000
2025-07-03,A00828,BIASHARA6W,0,230,230
2025-07-03,A00831,BIASHARA4W,250,1250,1500
2025-07-03,A00832,BIASHARA4W,0,500,500
2025-07-03,A00833,BIASHARA6W,334,434,768
2025-07-03,A00834,BIASHARA6W,334,834,1168
2025-07-03,A00841,INUKA6WKS,0,600,600
2025-07-03,A00863,INUKA6WKS,500,1667,2167
2025-07-03,A00866,BIASHARA4W,0,100,100
2025-07-03,A00868,BIASHARA6W,650,1350,2000
2025-07-03,A00878,INUKA6WKS,506,1167,1673
2025-07-03,A00884,BIASHARA4W,0,100,100
2025-07-03,A00888,BIASHARA6W,0,668,668
2025-07-04,A00607,BIASHARA4W,90,110,200
2025-07-04,A00643,INUKA6WKS,482,1165,1647
2025-07-04,A00657,INUKA8WKS,0,500,500
2025-07-04,A00665,BIASHARA6W,334,830,1164
2025-07-04,A00675,INUKA6WKS,500,1167,1667
2025-07-04,A00683,BIASHARA6W,334,834,1168
2025-07-04,A00684,BIASHARA6W,106,394,500
2025-07-04,A00692,INUKA8WKS,37,563,600
2025-07-04,A00721,INUKA6WKS,1499,3501,5000
2025-07-04,A00726,INUKA8WKS,0,800,800
2025-07-04,A00727,INUKA 4WKS,500,2475,2975
2025-07-04,A00728,INUKA6WKS,500,1167,1667
2025-07-04,A00731,BIASHARA4W,0,500,500
2025-07-04,A00733,INUKA6WKS,497,303,800
2025-07-04,A00735,INUKA6WKS,200,0,200
2025-07-04,A00738,BIASHARA4W,242,1250,1492
2025-07-04,A00747,BIASHARA4W,242,1250,1492
2025-07-04,A00767,BIASHARA6W,334,834,1168
2025-07-04,A00771,BIASHARA6W,334,834,1168
2025-07-04,A00796,BIASHARA4W,320,1250,1570
2025-07-04,A00803,INUKA 4WKS,500,2000,2500
2025-07-04,A00811,BIASHARA4W,250,1750,2000
2025-07-04,A00812,INUKA 4WKS,500,1500,2000
2025-07-04,A00813,BIASHARA4W,250,1250,1500
2025-07-04,A00818,INUKA6WKS,500,1167,1667
2025-07-04,A00821,BIASHARA6W,334,666,1000
2025-07-04,A00827,BIASHARA4W,0,500,500
2025-07-04,A00832,BIASHARA4W,50,330,380
2025-07-04,A00879,INUKA8WKS,500,475,975
2025-07-04,A00885,INUKA 4WKS,500,1750,2250
2025-07-04,A00886,BIASHARA4W,250,1250,1500
2025-07-04,A00887,BIASHARA4W,282,1250,1532
2025-07-04,A00890,INUKA6WKS,500,567,1067
2025-07-04,A00892,INUKA6WKS,300,0,300
2025-07-04,A00893,BIASHARA6W,334,166,500
2025-07-04,A00900,INUKA6WKS,400,0,400
2025-07-05,A00573,BIASHARA6W,0,500,500
2025-07-05,A00654,INUKA6WKS,136,864,1000
2025-07-05,A00708,BIASHARA6W,328,372,700
2025-07-05,A00720,INUKA6WKS,503,1667,2170
2025-07-05,A00735,INUKA6WKS,250,0,250
2025-07-05,A00759,INUKA6WKS,500,500,1000
2025-07-05,A00787,BIASHARA4W,250,550,800
2025-07-05,A00788,BIASHARA6W,334,834,1168
2025-07-05,A00793,BIASHARA6W,0,180,180
2025-07-05,A00802,BIASHARA4W,500,1500,2000
2025-07-05,A00805,INUKA 4WKS,500,500,1000
2025-07-05,A00819,INUKA6WKS,500,1667,2167
2025-07-05,A00830,INUKA6WKS,500,1167,1667
2025-07-05,A00832,BIASHARA4W,0,200,200
2025-07-05,A00833,BIASHARA6W,0,200,200
2025-07-05,A00883,INUKA6WKS,500,1000,1500
2025-07-05,A00890,INUKA6WKS,0,600,600
2025-07-05,A00892,INUKA6WKS,200,150,350
2025-07-05,A00895,BIASHARA4W,250,1050,1300
2025-07-06,A00465,BIASHARA4W,0,4,4
2025-07-06,A00504,BIASHARA6W,0,200,200
2025-07-06,A00769,INUKA6WKS,500,500,1000
2025-07-06,A00786,BIASHARA4W,250,1250,1500
2025-07-06,A00793,BIASHARA6W,2,298,300
2025-07-06,A00796,BIASHARA4W,100,0,100
2025-07-06,A00800,BIASHARA4W,0,2,2
2025-07-06,A00813,BIASHARA4W,1,217,218
2025-07-06,A00821,BIASHARA6W,0,168,168
2025-07-06,A00828,BIASHARA6W,334,204,538
2025-07-06,A00837,BIASHARA4W,250,1250,1500
2025-07-06,A00850,BIASHARA4W,250,1250,1500
2025-07-06,A00851,INUKA8WKS,500,750,1250
2025-07-06,A00853,BIASHARA4W,250,1250,1500
2025-07-06,A00871,BIASHARA6W,284,16,300
2025-07-06,A00892,INUKA6WKS,0,300,300
2025-07-06,A00895,BIASHARA4W,0,200,200
2025-07-06,A00896,BIASHARA6W,666,834,1500
2025-07-06,A00900,INUKA6WKS,0,900,900
2025-07-07,A00455,BIASHARA6W,0,200,200
2025-07-07,A00504,BIASHARA6W,0,100,100
2025-07-07,A00630,INUKA 4WKS,0,300,300
2025-07-07,A00646,BIASHARA6W,308,542,850
2025-07-07,A00654,INUKA6WKS,864,2334,3198
2025-07-07,A00674,BIASHARA6W,328,834,1162
2025-07-07,A00693,BIASHARA6W,426,1574,2000
2025-07-07,A00704,INUKA 4WKS,1000,3000,4000
2025-07-07,A00711,INUKA6WKS,733,1167,1900
2025-07-07,A00730,INUKA 4WKS,500,3500,4000
2025-07-07,A00735,INUKA6WKS,49,851,900
2025-07-07,A00736,INUKA6WKS,503,1167,1670
2025-07-07,A00741,BIASHARA6W,1001,2502,3503
2025-07-07,A00769,INUKA6WKS,0,667,667
2025-07-07,A00780,BIASHARA6W,336,834,1170
2025-07-07,A00781,BIASHARA4W,250,1250,1500
2025-07-07,A00789,INUKA6WKS,500,767,1267
2025-07-07,A00796,BIASHARA4W,80,495,575
2025-07-07,A00800,BIASHARA4W,250,0,250
2025-07-07,A00832,BIASHARA4W,0,220,220
2025-07-07,A00833,BIASHARA6W,0,200,200
2025-07-07,A00835,BIASHARA4W,250,1050,1300
2025-07-07,A00836,INUKA 4WKS,500,2250,2750
2025-07-07,A00837,BIASHARA4W,500,2500,3000
2025-07-07,A00842,BIASHARA6W,334,834,1168
2025-07-07,A00848,INUKA 4WKS,500,1750,2250
2025-07-07,A00849,BIASHARA4W,250,1250,1500
2025-07-07,A00871,BIASHARA6W,52,148,200
2025-07-07,A00879,INUKA8WKS,0,400,400
2025-07-07,A00892,INUKA6WKS,0,717,717
2025-07-07,A00893,BIASHARA6W,0,668,668
2025-07-07,A00894,BIASHARA4W,250,1250,1500
2025-07-07,A00898,INUKA 4WKS,500,1750,2250
2025-07-07,A00900,INUKA6WKS,33,267,300
2025-07-07,A00906,INUKA 4WKS,250,0,250
2025-07-07,A00917,BIASHARA4W,250,1250,1500
2025-07-08,A00076,BIASHARA4W,0,100,100
2025-07-08,A00132,BIASHARA4W,250,130,380
2025-07-08,A00455,BIASHARA6W,0,143,143
2025-07-08,A00504,BIASHARA6W,0,100,100
2025-07-08,A00592,BIASHARA6W,0,200,200
2025-07-08,A00607,BIASHARA4W,160,40,200
2025-07-08,A00646,BIASHARA6W,0,240,240
2025-07-08,A00693,BIASHARA6W,242,830,1072
2025-07-08,A00700,BIASHARA6W,0,250,250
2025-07-08,A00732,INUKA6WKS,500,500,1000
2025-07-08,A00733,INUKA6WKS,0,500,500
2025-07-08,A00734,BIASHARA6W,334,1002,1336
2025-07-08,A00735,INUKA6WKS,1,316,317
2025-07-08,A00745,INUKA6WKS,973,2027,3000
2025-07-08,A00748,INUKA 4WKS,500,1750,2250
2025-07-08,A00759,INUKA6WKS,0,500,500
2025-07-08,A00773,BIASHARA4W,250,750,1000
2025-07-08,A00779,INUKA 4WKS,500,1750,2250
2025-07-08,A00781,BIASHARA4W,250,1250,1500
2025-07-08,A00782,BIASHARA6W,293,507,800
2025-07-08,A00787,BIASHARA4W,0,700,700
2025-07-08,A00789,INUKA6WKS,0,400,400
2025-07-08,A00793,BIASHARA6W,334,834,1168
2025-07-08,A00799,BIASHARA6W,26,834,860
2025-07-08,A00800,BIASHARA4W,0,1050,1050
2025-07-08,A00801,BIASHARA6W,334,834,1168
2025-07-08,A00802,BIASHARA4W,0,1000,1000
2025-07-08,A00803,INUKA 4WKS,500,2000,2500
2025-07-08,A00807,INUKA6WKS,500,1500,2000
2025-07-08,A00814,BIASHARA6W,334,834,1168
2025-07-08,A00840,INUKA 4WKS,500,1500,2000
2025-07-08,A00855,INUKA 4WKS,500,1750,2250
2025-07-08,A00856,BIASHARA4W,250,1250,1500
2025-07-08,A00857,BIASHARA4W,250,1250,1500
2025-07-08,A00858,INUKA 4WKS,500,850,1350
2025-07-08,A00862,BIASHARA6W,351,834,1185
2025-07-08,A00864,INUKA 4WKS,500,1500,2000
2025-07-08,A00865,INUKA8WKS,525,875,1400
2025-07-08,A00869,BIASHARA4W,250,1250,1500
2025-07-08,A00871,BIASHARA6W,0,670,670
2025-07-08,A00872,INUKA 4WKS,500,500,1000
2025-07-08,A00875,BIASHARA6W,334,834,1168
2025-07-08,A00877,BIASHARA4W,250,1250,1500
2025-07-08,A00892,INUKA6WKS,250,0,250
2025-07-08,A00897,INUKA 4WKS,550,2250,2800
2025-07-08,A00899,BIASHARA4W,250,1250,1500
2025-07-08,A00902,INUKA6WKS,500,1000,1500
2025-07-08,A00935,BIASHARA6W,334,834,1168
2025-07-09,A00408,BIASHARA6W,280,320,600
2025-07-09,A00504,BIASHARA6W,0,150,150
2025-07-09,A00590,INUKA8WKS,500,750,1250
2025-07-09,A00593,INUKA6WKS,0,250,250
2025-07-09,A00607,BIASHARA4W,0,100,100
2025-07-09,A00646,BIASHARA6W,0,48,48
2025-07-09,A00666,INUKA6WKS,500,1165,1665
2025-07-09,A00671,BIASHARA6W,334,306,640
2025-07-09,A00673,BIASHARA6W,334,830,1164
2025-07-09,A00692,INUKA8WKS,463,337,800
2025-07-09,A00701,INUKA8WKS,500,500,1000
2025-07-09,A00719,INUKA6WKS,503,1167,1670
2025-07-09,A00722,BIASHARA4W,250,1950,2200
2025-07-09,A00750,INUKA8WKS,0,500,500
2025-07-09,A00751,INUKA6WKS,503,1667,2170
2025-07-09,A00752,BIASHARA6W,332,828,1160
2025-07-09,A00761,BIASHARA4W,250,1250,1500
2025-07-09,A00762,INUKA6WKS,500,1167,1667
2025-07-09,A00763,INUKA6WKS,467,1093,1560
2025-07-09,A00765,BIASHARA6W,334,834,1168
2025-07-09,A00773,BIASHARA4W,0,500,500
2025-07-09,A00779,INUKA 4WKS,500,1750,2250
2025-07-09,A00783,BIASHARA6W,336,834,1170
2025-07-09,A00787,BIASHARA4W,246,1250,1496
2025-07-09,A00796,BIASHARA4W,0,495,495
2025-07-09,A00800,BIASHARA4W,0,140,140
2025-07-09,A00803,INUKA 4WKS,500,2000,2500
2025-07-09,A00806,INUKA 4WKS,500,2500,3000
2025-07-09,A00811,BIASHARA4W,250,550,800
2025-07-09,A00816,BIASHARA4W,250,1250,1500
2025-07-09,A00827,BIASHARA4W,250,250,500
2025-07-09,A00835,BIASHARA4W,0,200,200
2025-07-09,A00840,INUKA 4WKS,0,500,500
2025-07-09,A00853,BIASHARA4W,500,2500,3000
2025-07-09,A00858,INUKA 4WKS,0,300,300
2025-07-09,A00861,BIASHARA4W,250,1250,1500
2025-07-09,A00863,INUKA6WKS,500,1667,2167
2025-07-09,A00864,INUKA 4WKS,0,500,500
2025-07-09,A00866,BIASHARA4W,250,550,800
2025-07-09,A00872,INUKA 4WKS,0,1250,1250
2025-07-09,A00887,BIASHARA4W,133,0,133
2025-07-09,A00901,BIASHARA4W,250,1250,1500
2025-07-09,A00904,INUKA 4WKS,500,1750,2250
2025-07-09,A00906,INUKA 4WKS,250,1750,2000
2025-07-09,A00938,BIASHARA4W,200,0,200
2025-07-09,A00986,INUKA6WKS,0,248,248
2025-07-10,A00504,BIASHARA6W,0,100,100
2025-07-10,A00573,BIASHARA6W,0,148,148
2025-07-10,A00590,INUKA8WKS,440,750,1190
2025-07-10,A00592,BIASHARA6W,236,14,250
2025-07-10,A00607,BIASHARA4W,0,100,100
2025-07-10,A00671,BIASHARA6W,172,528,700
2025-07-10,A00674,BIASHARA6W,334,830,1164
2025-07-10,A00678,BIASHARA4W,0,100,100
2025-07-10,A00684,BIASHARA6W,228,272,500
2025-07-10,A00692,INUKA8WKS,0,400,400
2025-07-10,A00701,INUKA8WKS,0,500,500
2025-07-10,A00709,INUKA6WKS,502,1334,1836
2025-07-10,A00711,INUKA6WKS,265,935,1200
2025-07-10,A00726,INUKA8WKS,500,100,600
2025-07-10,A00732,INUKA6WKS,500,1500,2000
2025-07-10,A00745,INUKA6WKS,3,307,310
2025-07-10,A00751,INUKA6WKS,952,3334,4286
2025-07-10,A00752,BIASHARA6W,4,6,10
2025-07-10,A00763,INUKA6WKS,0,74,74
2025-07-10,A00766,BIASHARA6W,334,834,1168
2025-07-10,A00768,BIASHARA6W,334,834,1168
2025-07-10,A00771,BIASHARA6W,334,834,1168
2025-07-10,A00778,BIASHARA6W,334,834,1168
2025-07-10,A00782,BIASHARA6W,334,766,1100
2025-07-10,A00795,BIASHARA6W,325,5,330
2025-07-10,A00800,BIASHARA4W,0,60,60
2025-07-10,A00803,INUKA 4WKS,500,2000,2500
2025-07-10,A00806,INUKA 4WKS,500,2500,3000
2025-07-10,A00809,BIASHARA6W,334,566,900
2025-07-10,A00810,BIASHARA6W,334,834,1168
2025-07-10,A00811,BIASHARA4W,0,200,200
2025-07-10,A00817,INUKA8WKS,500,875,1375
2025-07-10,A00820,INUKA6WKS,500,1167,1667
2025-07-10,A00827,BIASHARA4W,0,800,800
2025-07-10,A00828,BIASHARA6W,8,660,668
2025-07-10,A00831,BIASHARA4W,250,1250,1500
2025-07-10,A00832,BIASHARA4W,250,50,300
2025-07-10,A00833,BIASHARA6W,334,834,1168
2025-07-10,A00834,BIASHARA6W,334,834,1168
2025-07-10,A00841,INUKA6WKS,500,1167,1667
2025-07-10,A00858,INUKA 4WKS,0,550,550
2025-07-10,A00868,BIASHARA6W,0,318,318
2025-07-10,A00878,INUKA6WKS,500,1167,1667
2025-07-10,A00882,BIASHARA6W,334,834,1168
2025-07-10,A00883,INUKA6WKS,500,1000,1500
2025-07-10,A00884,BIASHARA4W,250,1250,1500
2025-07-10,A00887,BIASHARA4W,150,1250,1400
2025-07-10,A00892,INUKA6WKS,250,137,387
2025-07-10,A00905,BIASHARA4W,250,1250,1500
2025-07-10,A00908,BIASHARA6W,361,834,1195
2025-07-10,A00909,BIASHARA6W,200,0,200
2025-07-10,A00910,INUKA6WKS,500,1000,1500
2025-07-10,A00913,BIASHARA4W,250,1250,1500
2025-07-10,A00914,INUKA6WKS,500,100,600
2025-07-10,A00915,BIASHARA4W,250,1250,1500
2025-07-10,A00919,BIASHARA6W,500,800,1300
2025-07-10,A00938,BIASHARA4W,50,150,200
2025-07-10,A00941,INUKA 4WKS,1000,2000,3000
2025-07-11,A00607,BIASHARA4W,0,100,100
2025-07-11,A00630,INUKA 4WKS,0,100,100
2025-07-11,A00675,INUKA6WKS,488,1165,1653
2025-07-11,A00676,INUKA6WKS,503,1264,1767
2025-07-11,A00683,BIASHARA6W,334,266,600
2025-07-11,A00700,BIASHARA6W,0,200,200
2025-07-11,A00708,BIASHARA6W,0,400,400
2025-07-11,A00720,INUKA6WKS,458,709,1167
2025-07-11,A00726,INUKA8WKS,0,900,900
2025-07-11,A00732,INUKA6WKS,500,2500,3000
2025-07-11,A00749,BIASHARA4W,250,750,1000
2025-07-11,A00752,BIASHARA6W,664,1668,2332
2025-07-11,A00763,INUKA6WKS,1000,2334,3334
2025-07-11,A00767,BIASHARA6W,334,834,1168
2025-07-11,A00773,BIASHARA4W,250,1250,1500
2025-07-11,A00775,BIASHARA4W,200,0,200
2025-07-11,A00776,INUKA6WKS,1927,4073,6000
2025-07-11,A00791,BIASHARA4W,250,1250,1500
2025-07-11,A00809,BIASHARA6W,0,268,268
2025-07-11,A00812,INUKA 4WKS,500,1500,2000
2025-07-11,A00813,BIASHARA4W,250,1250,1500
2025-07-11,A00818,INUKA6WKS,500,1167,1667
2025-07-11,A00821,BIASHARA6W,334,166,500
2025-07-11,A00827,BIASHARA4W,0,200,200
2025-07-11,A00830,INUKA6WKS,497,770,1267
2025-07-11,A00831,BIASHARA4W,250,1250,1500
2025-07-11,A00832,BIASHARA4W,0,300,300
2025-07-11,A00866,BIASHARA4W,0,700,700
2025-07-11,A00879,INUKA8WKS,500,270,770
2025-07-11,A00886,BIASHARA4W,250,1250,1500
2025-07-11,A00888,BIASHARA6W,334,166,500
2025-07-11,A00890,INUKA6WKS,500,1167,1667
2025-07-11,A00892,INUKA6WKS,0,300,300
2025-07-11,A00907,BIASHARA4W,250,1250,1500
2025-07-11,A00909,BIASHARA6W,134,834,968
2025-07-11,A00911,BIASHARA4W,250,1250,1500
2025-07-11,A00912,INUKA 4WKS,200,0,200
2025-07-11,A00914,INUKA6WKS,0,900,900
2025-07-11,A00939,BIASHARA4W,250,750,1000
2025-07-12,A00076,BIASHARA4W,0,100,100
2025-07-12,A00455,BIASHARA6W,64,481,545
2025-07-12,A00683,BIASHARA6W,0,500,500
2025-07-12,A00735,INUKA6WKS,400,0,400
2025-07-12,A00749,BIASHARA4W,0,200,200
2025-07-12,A00772,INUKA6WKS,0,300,300
2025-07-12,A00775,BIASHARA4W,50,1250,1300
2025-07-12,A00832,BIASHARA4W,0,505,505
2025-07-12,A00885,INUKA 4WKS,500,1750,2250
2025-07-12,A00888,BIASHARA6W,0,540,540
2025-07-12,A00892,INUKA6WKS,0,300,300
2025-07-12,A00914,INUKA6WKS,0,167,167
2025-07-12,A00916,INUKA6WKS,500,1167,1667
2025-07-12,A00934,BIASHARA6W,0,400,400
2025-07-12,A00938,BIASHARA4W,0,200,200
2025-07-12,A00941,INUKA 4WKS,0,100,100
2025-07-13,A00504,BIASHARA6W,48,52,100
2025-07-13,A00592,BIASHARA6W,98,52,150
2025-07-13,A00607,BIASHARA4W,0,100,100
2025-07-13,A00676,INUKA6WKS,350,0,350
2025-07-13,A00700,BIASHARA6W,0,200,200
2025-07-13,A00712,BIASHARA6W,334,834,1168
2025-07-13,A00735,INUKA6WKS,99,101,200
2025-07-13,A00789,INUKA6WKS,500,107,607
2025-07-13,A00821,BIASHARA6W,0,668,668
2025-07-13,A00848,INUKA 4WKS,400,0,400
2025-07-13,A00849,BIASHARA4W,250,250,500
2025-07-13,A00850,BIASHARA4W,250,1250,1500
2025-07-13,A00888,BIASHARA6W,0,128,128
2025-07-13,A00892,INUKA6WKS,0,300,300
2025-07-13,A00895,BIASHARA4W,250,1250,1500
2025-07-13,A00896,BIASHARA6W,336,1164,1500
2025-07-13,A00900,INUKA6WKS,533,1167,1700
2025-07-13,A00927,INUKA6WKS,500,167,667
2025-07-13,A00928,BIASHARA4W,250,1250,1500
2025-07-13,A00938,BIASHARA4W,0,200,200
2025-07-13,A00940,BIASHARA4W,250,1250,1500
2025-07-14,A00076,BIASHARA4W,250,400,650
2025-07-14,A00132,BIASHARA4W,0,300,300
2025-07-14,A00360,BIASHARA4W,0,140,140
2025-07-14,A00504,BIASHARA6W,100,0,100
2025-07-14,A00684,BIASHARA6W,334,1396,1730
2025-07-14,A00692,INUKA8WKS,37,388,425
2025-07-14,A00700,BIASHARA6W,92,108,200
2025-07-14,A00708,BIASHARA6W,334,666,1000
2025-07-14,A00711,INUKA6WKS,1000,2566,3566
2025-07-14,A00720,INUKA6WKS,42,958,1000
2025-07-14,A00733,INUKA6WKS,0,257,257
2025-07-14,A00736,INUKA6WKS,488,1072,1560
2025-07-14,A00749,BIASHARA4W,0,200,200
2025-07-14,A00780,BIASHARA6W,336,834,1170
2025-07-14,A00782,BIASHARA6W,0,395,395
2025-07-14,A00783,BIASHARA6W,332,73,405
2025-07-14,A00786,BIASHARA4W,250,1250,1500
2025-07-14,A00788,BIASHARA6W,334,834,1168
2025-07-14,A00789,INUKA6WKS,0,410,410
2025-07-14,A00790,INUKA 4WKS,500,500,1000
2025-07-14,A00791,BIASHARA4W,250,1250,1500
2025-07-14,A00800,BIASHARA4W,100,0,100
2025-07-14,A00801,BIASHARA6W,334,834,1168
2025-07-14,A00830,INUKA6WKS,3,397,400
2025-07-14,A00832,BIASHARA4W,0,395,395
2025-07-14,A00835,BIASHARA4W,400,1250,1650
2025-07-14,A00836,INUKA 4WKS,1000,4500,5500
2025-07-14,A00840,INUKA 4WKS,1000,4000,5000
2025-07-14,A00842,BIASHARA6W,334,834,1168
2025-07-14,A00848,INUKA 4WKS,600,3500,4100
2025-07-14,A00849,BIASHARA4W,0,1000,1000
2025-07-14,A00851,INUKA8WKS,500,750,1250
2025-07-14,A00858,INUKA 4WKS,250,50,300
2025-07-14,A00871,BIASHARA6W,282,218,500
2025-07-14,A00879,INUKA8WKS,0,605,605
2025-07-14,A00887,BIASHARA4W,151,0,151
2025-07-14,A00892,INUKA6WKS,0,130,130
2025-07-14,A00894,BIASHARA4W,250,750,1000
2025-07-14,A00903,BIASHARA4W,250,640,890
2025-07-14,A00904,INUKA 4WKS,500,850,1350
2025-07-14,A00912,INUKA 4WKS,300,200,500
2025-07-14,A00920,INUKA 4WKS,500,1300,1800
2025-07-14,A00925,INUKA 4WKS,500,1750,2250
2025-07-14,A00929,INUKA 4WKS,500,1750,2250
2025-07-14,A00931,BIASHARA6W,334,834,1168
2025-07-14,A00933,INUKA 4WKS,500,1750,2250
2025-07-14,A00937,BIASHARA6W,334,834,1168
2025-07-14,A00939,BIASHARA4W,0,500,500
2025-07-14,A00958,BIASHARA6W,100,0,100
2025-07-15,A00132,BIASHARA4W,0,258,258
2025-07-15,A00401,INUKA6WKS,33,167,200
2025-07-15,A00455,BIASHARA6W,270,830,1100
2025-07-15,A00607,BIASHARA4W,0,100,100
2025-07-15,A00692,INUKA8WKS,463,157,620
2025-07-15,A00708,BIASHARA6W,0,230,230
2025-07-15,A00734,BIASHARA6W,334,766,1100
2025-07-15,A00735,INUKA6WKS,1,1066,1067
2025-07-15,A00783,BIASHARA6W,0,680,680
2025-07-15,A00795,BIASHARA6W,9,829,838
2025-07-15,A00800,BIASHARA4W,150,1250,1400
2025-07-15,A00835,BIASHARA4W,100,1250,1350
2025-07-15,A00850,BIASHARA4W,250,1250,1500
2025-07-15,A00852,BIASHARA6W,334,834,1168
2025-07-15,A00855,INUKA 4WKS,500,1750,2250
2025-07-15,A00856,BIASHARA4W,250,1250,1500
2025-07-15,A00857,BIASHARA4W,250,1250,1500
2025-07-15,A00858,INUKA 4WKS,250,130,380
2025-07-15,A00869,BIASHARA4W,250,1250,1500
2025-07-15,A00871,BIASHARA6W,0,520,520
2025-07-15,A00875,BIASHARA6W,334,834,1168
2025-07-15,A00877,BIASHARA4W,250,1250,1500
2025-07-15,A00887,BIASHARA4W,284,2500,2784
2025-07-15,A00892,INUKA6WKS,250,0,250
2025-07-15,A00894,BIASHARA4W,0,500,500
2025-07-15,A00898,INUKA 4WKS,500,1750,2250
2025-07-15,A00899,BIASHARA4W,250,50,300
2025-07-15,A00903,BIASHARA4W,0,610,610
2025-07-15,A00904,INUKA 4WKS,0,550,550
2025-07-15,A00905,BIASHARA4W,250,550,800
2025-07-15,A00912,INUKA 4WKS,0,550,550
2025-07-15,A00920,INUKA 4WKS,0,400,400
2025-07-15,A00927,INUKA6WKS,0,350,350
2025-07-15,A00932,INUKA 4WKS,500,1750,2250
2025-07-15,A00934,BIASHARA6W,21,379,400
2025-07-15,A00935,BIASHARA6W,334,216,550
2025-07-15,A00938,BIASHARA4W,0,200,200
2025-07-15,A00943,BIASHARA6W,334,834,1168
2025-07-16,A00076,BIASHARA4W,0,300,300
2025-07-16,A00132,BIASHARA4W,0,280,280
2025-07-16,A00360,BIASHARA4W,0,860,860
2025-07-16,A00499,BIASHARA6W,158,182,340
2025-07-16,A00592,BIASHARA6W,0,140,140
2025-07-16,A00701,INUKA8WKS,500,1000,1500
2025-07-16,A00734,BIASHARA6W,0,68,68
2025-07-16,A00750,INUKA8WKS,225,75,300
2025-07-16,A00759,INUKA6WKS,0,500,500
2025-07-16,A00762,INUKA6WKS,500,450,950
2025-07-16,A00768,BIASHARA6W,668,1668,2336
2025-07-16,A00789,INUKA6WKS,350,650,1000
2025-07-16,A00796,BIASHARA4W,165,260,425
2025-07-16,A00807,INUKA6WKS,500,1500,2000
2025-07-16,A00813,BIASHARA4W,249,151,400
2025-07-16,A00816,BIASHARA4W,250,1250,1500
2025-07-16,A00827,BIASHARA4W,250,1250,1500
2025-07-16,A00849,BIASHARA4W,250,1250,1500
2025-07-16,A00858,INUKA 4WKS,0,1060,1060
2025-07-16,A00862,BIASHARA6W,334,834,1168
2025-07-16,A00863,INUKA6WKS,500,1667,2167
2025-07-16,A00864,INUKA 4WKS,500,2000,2500
2025-07-16,A00866,BIASHARA4W,250,550,800
2025-07-16,A00871,BIASHARA6W,54,96,150
2025-07-16,A00872,INUKA 4WKS,500,300,800
2025-07-16,A00882,BIASHARA6W,334,834,1168
2025-07-16,A00892,INUKA6WKS,250,50,300
2025-07-16,A00893,BIASHARA6W,334,366,700
2025-07-16,A00897,INUKA 4WKS,490,2250,2740
2025-07-16,A00901,BIASHARA4W,250,1250,1500
2025-07-16,A00902,INUKA6WKS,500,1000,1500
2025-07-16,A00904,INUKA 4WKS,0,350,350
2025-07-16,A00905,BIASHARA4W,0,700,700
2025-07-16,A00906,INUKA 4WKS,500,1750,2250
2025-07-16,A00909,BIASHARA6W,334,166,500
2025-07-16,A00912,INUKA 4WKS,0,800,800
2025-07-16,A00920,INUKA 4WKS,0,50,50
2025-07-16,A00927,INUKA6WKS,0,650,650
2025-07-16,A00934,BIASHARA6W,250,0,250
2025-07-16,A00935,BIASHARA6W,0,618,618
2025-07-16,A00938,BIASHARA4W,0,500,500
2025-07-16,A00941,INUKA 4WKS,0,100,100
2025-07-16,A00942,INUKA 4WKS,500,1750,2250
2025-07-16,A00944,INUKA6WKS,500,0,500
2025-07-16,A00948,INUKA6WKS,503,1667,2170
2025-07-16,A00949,INUKA8WKS,500,100,600
2025-07-17,A00132,BIASHARA4W,0,282,282
2025-07-17,A00412,INUKA6WKS,0,300,300
2025-07-17,A00504,BIASHARA6W,50,0,50
2025-07-17,A00607,BIASHARA4W,0,200,200
2025-07-17,A00692,INUKA8WKS,0,820,820
2025-07-17,A00701,INUKA8WKS,1000,2000,3000
2025-07-17,A00709,INUKA6WKS,392,1330,1722
2025-07-17,A00719,INUKA6WKS,488,1165,1653
2025-07-17,A00735,INUKA6WKS,499,501,1000
2025-07-17,A00750,INUKA8WKS,275,625,900
2025-07-17,A00762,INUKA6WKS,33,717,750
2025-07-17,A00766,BIASHARA6W,334,834,1168
2025-07-17,A00769,INUKA6WKS,500,500,1000
2025-07-17,A00771,BIASHARA6W,659,1668,2327
2025-07-17,A00778,BIASHARA6W,334,834,1168
2025-07-17,A00780,BIASHARA6W,648,1668,2316
2025-07-17,A00790,INUKA 4WKS,0,1000,1000
2025-07-17,A00796,BIASHARA4W,85,415,500
2025-07-17,A00799,BIASHARA6W,366,834,1200
2025-07-17,A00809,BIASHARA6W,334,166,500
2025-07-17,A00810,BIASHARA6W,334,666,1000
2025-07-17,A00811,BIASHARA4W,250,1250,1500
2025-07-17,A00812,INUKA 4WKS,500,1500,2000
2025-07-17,A00813,BIASHARA4W,0,999,999
2025-07-17,A00818,INUKA6WKS,500,1167,1667
2025-07-17,A00819,INUKA6WKS,500,1117,1617
2025-07-17,A00821,BIASHARA6W,1002,2502,3504
2025-07-17,A00832,BIASHARA4W,250,50,300
2025-07-17,A00834,BIASHARA6W,334,834,1168
2025-07-17,A00855,INUKA 4WKS,500,1750,2250
2025-07-17,A00858,INUKA 4WKS,20,560,580
2025-07-17,A00865,INUKA8WKS,525,875,1400
2025-07-17,A00866,BIASHARA4W,0,700,700
2025-07-17,A00868,BIASHARA6W,334,666,1000
2025-07-17,A00872,INUKA 4WKS,0,1250,1250
2025-07-17,A00884,BIASHARA4W,250,1050,1300
2025-07-17,A00885,INUKA 4WKS,1000,3500,4500
2025-07-17,A00886,BIASHARA4W,250,1250,1500
2025-07-17,A00888,BIASHARA6W,334,666,1000
2025-07-17,A00892,INUKA6WKS,0,200,200
2025-07-17,A00893,BIASHARA6W,0,100,100
2025-07-17,A00899,BIASHARA4W,0,1200,1200
2025-07-17,A00907,BIASHARA4W,250,1250,1500
2025-07-17,A00908,BIASHARA6W,334,834,1168
2025-07-17,A00910,INUKA6WKS,500,1000,1500
2025-07-17,A00912,INUKA 4WKS,0,200,200
2025-07-17,A00913,BIASHARA4W,250,500,750
2025-07-17,A00915,BIASHARA4W,250,250,500
2025-07-17,A00917,BIASHARA4W,250,1250,1500
2025-07-17,A00934,BIASHARA6W,63,87,150
2025-07-17,A00938,BIASHARA4W,200,0,200
2025-07-17,A00944,INUKA6WKS,0,500,500
2025-07-17,A00949,INUKA8WKS,0,650,650
2025-07-17,A00950,INUKA6WKS,500,1167,1667
2025-07-17,A00953,BIASHARA4W,250,1250,1500
2025-07-17,A00954,INUKA6WKS,500,200,700
2025-07-17,A00959,BIASHARA4W,250,250,500
2025-07-18,A00401,INUKA6WKS,200,0,200
2025-07-18,A00408,BIASHARA6W,0,500,500
2025-07-18,A00412,INUKA6WKS,0,250,250
2025-07-18,A00607,BIASHARA4W,0,100,100
2025-07-18,A00648,BIASHARA6W,54,146,200
2025-07-18,A00692,INUKA8WKS,37,148,185
2025-07-18,A00720,INUKA6WKS,458,1665,2123
2025-07-18,A00726,INUKA8WKS,1500,3000,4500
2025-07-18,A00733,INUKA6WKS,393,107,500
2025-07-18,A00735,INUKA6WKS,0,200,200
2025-07-18,A00767,BIASHARA6W,334,834,1168
2025-07-18,A00772,INUKA6WKS,0,500,500
2025-07-18,A00774,INUKA8WKS,468,427,895
2025-07-18,A00778,BIASHARA6W,334,830,1164
2025-07-18,A00782,BIASHARA6W,270,0,270
2025-07-18,A00783,BIASHARA6W,4,81,85
2025-07-18,A00793,BIASHARA6W,336,834,1170
2025-07-18,A00795,BIASHARA6W,326,834,1160
2025-07-18,A00796,BIASHARA4W,0,835,835
2025-07-18,A00810,BIASHARA6W,0,168,168
2025-07-18,A00813,BIASHARA4W,0,100,100
2025-07-18,A00817,INUKA8WKS,500,875,1375
2025-07-18,A00819,INUKA6WKS,0,550,550
2025-07-18,A00820,INUKA6WKS,500,1167,1667
2025-07-18,A00828,BIASHARA6W,326,274,600
2025-07-18,A00832,BIASHARA4W,0,400,400
2025-07-18,A00834,BIASHARA6W,668,1668,2336
2025-07-18,A00856,BIASHARA4W,250,1250,1500
2025-07-18,A00868,BIASHARA6W,0,100,100
2025-07-18,A00884,BIASHARA4W,0,200,200
2025-07-18,A00890,INUKA6WKS,500,1167,1667
2025-07-18,A00892,INUKA6WKS,0,300,300
2025-07-18,A00893,BIASHARA6W,0,368,368
2025-07-18,A00900,INUKA6WKS,300,0,300
2025-07-18,A00909,BIASHARA6W,0,200,200
2025-07-18,A00911,BIASHARA4W,250,1250,1500
2025-07-18,A00914,INUKA6WKS,500,400,900
2025-07-18,A00915,BIASHARA4W,0,1000,1000
2025-07-18,A00919,BIASHARA6W,668,1011,1679
2025-07-18,A00934,BIASHARA6W,0,100,100
2025-07-18,A00938,BIASHARA4W,50,150,200
2025-07-18,A00946,INUKA 4WKS,500,2500,3000
2025-07-18,A00947,BIASHARA6W,334,666,1000
2025-07-18,A00951,INUKA 4WKS,500,500,1000
2025-07-18,A00952,INUKA 4WKS,500,500,1000
2025-07-18,A00954,INUKA6WKS,0,800,800
2025-07-18,A00958,BIASHARA6W,266,834,1100
2025-07-18,A00959,BIASHARA4W,0,1000,1000
2025-07-18,A00960,BIASHARA6W,334,16,350
2025-07-19,A00076,BIASHARA4W,0,300,300
2025-07-19,A00735,INUKA6WKS,0,464,464
2025-07-19,A00736,INUKA6WKS,467,95,562
2025-07-19,A00809,BIASHARA6W,0,400,400
2025-07-19,A00814,BIASHARA6W,299,751,1050
2025-07-19,A00832,BIASHARA4W,0,400,400
2025-07-19,A00868,BIASHARA6W,0,68,68
2025-07-19,A00879,INUKA8WKS,500,560,1060
2025-07-19,A00883,INUKA6WKS,500,1000,1500
2025-07-19,A00888,BIASHARA6W,0,168,168
2025-07-19,A00892,INUKA6WKS,0,200,200
2025-07-19,A00895,BIASHARA4W,250,1250,1500
2025-07-19,A00909,BIASHARA6W,0,200,200
2025-07-19,A00912,INUKA 4WKS,500,400,900
2025-07-19,A00913,BIASHARA4W,0,750,750
2025-07-19,A00914,INUKA6WKS,0,500,500
2025-07-19,A00944,INUKA6WKS,0,834,834
2025-07-19,A00957,BIASHARA4W,250,250,500
2025-07-19,A00960,BIASHARA6W,0,350,350
2025-07-20,A00504,BIASHARA6W,100,0,100
2025-07-20,A00607,BIASHARA4W,0,200,200
2025-07-20,A00676,INUKA6WKS,147,253,400
2025-07-20,A00722,BIASHARA4W,0,200,200
2025-07-20,A00782,BIASHARA6W,266,834,1100
2025-07-20,A00783,BIASHARA6W,334,834,1168
2025-07-20,A00832,BIASHARA4W,0,200,200
2025-07-20,A00841,INUKA6WKS,500,1167,1667
2025-07-20,A00842,BIASHARA6W,334,834,1168
2025-07-20,A00851,INUKA8WKS,500,750,1250
2025-07-20,A00875,BIASHARA6W,341,834,1175
2025-07-20,A00878,INUKA6WKS,500,1167,1667
2025-07-20,A00892,INUKA6WKS,0,250,250
2025-07-20,A00900,INUKA6WKS,134,366,500
2025-07-20,A00909,BIASHARA6W,0,268,268
2025-07-20,A00914,INUKA6WKS,0,145,145
2025-07-20,A00938,BIASHARA4W,0,400,400
2025-07-20,A00951,INUKA 4WKS,0,1500,1500
2025-07-20,A00968,INUKA 4WKS,500,0,500
2025-07-21,A00076,BIASHARA4W,0,200,200
2025-07-21,A00402,BIASHARA6W,130,0,130
2025-07-21,A00504,BIASHARA6W,36,64,100
2025-07-21,A00535,INUKA6WKS,200,0,200
2025-07-21,A00607,BIASHARA4W,0,210,210
2025-07-21,A00671,BIASHARA6W,162,8,170
2025-07-21,A00708,BIASHARA6W,300,0,300
2025-07-21,A00734,BIASHARA6W,334,830,1164
2025-07-21,A00736,INUKA6WKS,33,567,600
2025-07-21,A00765,BIASHARA6W,332,468,800
2025-07-21,A00769,INUKA6WKS,500,750,1250
2025-07-21,A00782,BIASHARA6W,132,830,962
2025-07-21,A00788,BIASHARA6W,334,734,1068
2025-07-21,A00789,INUKA6WKS,650,1350,2000
2025-07-21,A00790,INUKA 4WKS,0,1000,1000
2025-07-21,A00799,BIASHARA6W,293,7,300
2025-07-21,A00801,BIASHARA6W,668,1664,2332
2025-07-21,A00807,INUKA6WKS,982,3000,3982
2025-07-21,A00809,BIASHARA6W,0,200,200
2025-07-21,A00814,BIASHARA6W,668,1751,2419
2025-07-21,A00819,INUKA6WKS,500,1600,2100
2025-07-21,A00820,INUKA6WKS,1000,2334,3334
2025-07-21,A00832,BIASHARA4W,0,200,200
2025-07-21,A00852,BIASHARA6W,334,834,1168
2025-07-21,A00858,INUKA 4WKS,480,1750,2230
2025-07-21,A00861,BIASHARA4W,250,550,800
2025-07-21,A00869,BIASHARA4W,250,1250,1500
2025-07-21,A00871,BIASHARA6W,170,0,170
2025-07-21,A00872,INUKA 4WKS,500,750,1250
2025-07-21,A00892,INUKA6WKS,0,167,167
2025-07-21,A00893,BIASHARA6W,334,366,700
2025-07-21,A00896,BIASHARA6W,334,834,1168
2025-07-21,A00897,INUKA 4WKS,960,3040,4000
2025-07-21,A00898,INUKA 4WKS,1000,3000,4000
2025-07-21,A00899,BIASHARA4W,500,2500,3000
2025-07-21,A00900,INUKA6WKS,500,900,1400
2025-07-21,A00912,INUKA 4WKS,0,450,450
2025-07-21,A00914,INUKA6WKS,8,122,130
2025-07-21,A00920,INUKA 4WKS,500,1500,2000
2025-07-21,A00925,INUKA 4WKS,500,1750,2250
2025-07-21,A00933,INUKA 4WKS,500,1750,2250
2025-07-21,A00934,BIASHARA6W,0,150,150
2025-07-21,A00940,BIASHARA4W,250,1250,1500
2025-07-21,A00941,INUKA 4WKS,0,500,500
2025-07-21,A00951,INUKA 4WKS,0,250,250
2025-07-21,A00960,BIASHARA6W,0,468,468
2025-07-21,A00963,BIASHARA4W,250,1250,1500
2025-07-21,A00965,BIASHARA6W,334,834,1168
2025-07-21,A00966,INUKA8WKS,500,1000,1500
2025-07-21,A00967,INUKA 4WKS,500,2250,2750
2025-07-21,A00968,INUKA 4WKS,0,1750,1750
2025-07-21,A00970,INUKA 4WKS,500,1350,1850
2025-07-21,A00971,INUKA 4WKS,500,2000,2500
2025-07-21,A00972,INUKA6WKS,503,1167,1670
2025-07-21,A00973,BIASHARA4W,250,1250,1500
2025-07-21,A00974,INUKA 4WKS,500,1000,1500
2025-07-21,A00976,BIASHARA4W,250,1250,1500
2025-07-21,A00978,BIASHARA4W,250,1000,1250
2025-07-21,A00979,INUKA6WKS,500,1167,1667
2025-07-22,A00076,BIASHARA4W,0,155,155
2025-07-22,A00504,BIASHARA6W,0,100,100
2025-07-22,A00671,BIASHARA6W,0,200,200
2025-07-22,A00722,BIASHARA4W,0,104,104
2025-07-22,A00762,INUKA6WKS,467,133,600
2025-07-22,A00789,INUKA6WKS,0,982,982
2025-07-22,A00793,BIASHARA6W,330,740,1070
2025-07-22,A00799,BIASHARA6W,334,1661,1995
2025-07-22,A00809,BIASHARA6W,0,68,68
2025-07-22,A00810,BIASHARA6W,668,1668,2336
2025-07-22,A00857,BIASHARA4W,250,1250,1500
2025-07-22,A00863,INUKA6WKS,500,1667,2167
2025-07-22,A00864,INUKA 4WKS,500,2000,2500
2025-07-22,A00871,BIASHARA6W,110,590,700
2025-07-22,A00872,INUKA 4WKS,0,800,800
2025-07-22,A00877,BIASHARA4W,250,1250,1500
2025-07-22,A00879,INUKA8WKS,5,315,320
2025-07-22,A00892,INUKA6WKS,200,0,200
2025-07-22,A00894,BIASHARA4W,200,0,200
2025-07-22,A00897,INUKA 4WKS,0,1460,1460
2025-07-22,A00898,INUKA 4WKS,0,500,500
2025-07-22,A00900,INUKA6WKS,0,100,100
2025-07-22,A00902,INUKA6WKS,500,1000,1500
2025-07-22,A00903,BIASHARA4W,250,1250,1500
2025-07-22,A00906,INUKA 4WKS,400,0,400
2025-07-22,A00913,BIASHARA4W,250,1250,1500
2025-07-22,A00917,BIASHARA4W,250,1250,1500
2025-07-22,A00927,INUKA6WKS,335,0,335
2025-07-22,A00931,BIASHARA6W,300,0,300
2025-07-22,A00932,INUKA 4WKS,500,1750,2250
2025-07-22,A00937,BIASHARA6W,334,834,1168
2025-07-22,A00938,BIASHARA4W,0,400,400
2025-07-22,A00939,BIASHARA4W,250,750,1000
2025-07-22,A00941,INUKA 4WKS,0,600,600
2025-07-22,A00943,BIASHARA6W,334,834,1168
2025-07-22,A00947,BIASHARA6W,0,168,168
2025-07-22,A00948,INUKA6WKS,503,1667,2170
2025-07-22,A00970,INUKA 4WKS,0,400,400
2025-07-22,A00974,INUKA 4WKS,0,400,400
2025-07-22,A00975,INUKA6WKS,500,1167,1667
2025-07-22,A00977,BIASHARA4W,250,280,530
2025-07-22,A00978,BIASHARA4W,0,250,250
2025-07-22,A00981,INUKA 4WKS,500,339,839
2025-07-22,A00983,BIASHARA4W,250,950,1200
2025-07-22,A01026,BIASHARA4W,250,0,250
2025-07-23,A00408,BIASHARA6W,334,166,500
2025-07-23,A00678,BIASHARA4W,250,1050,1300
2025-07-23,A00692,INUKA8WKS,300,0,300
2025-07-23,A00750,INUKA8WKS,500,875,1375
2025-07-23,A00762,INUKA6WKS,0,1032,1032
2025-07-23,A00765,BIASHARA6W,334,1200,1534
2025-07-23,A00788,BIASHARA6W,0,100,100
2025-07-23,A00793,BIASHARA6W,334,96,430
2025-07-23,A00795,BIASHARA6W,334,834,1168
2025-07-23,A00841,INUKA6WKS,500,1167,1667
2025-07-23,A00862,BIASHARA6W,317,834,1151
2025-07-23,A00865,INUKA8WKS,525,875,1400
2025-07-23,A00866,BIASHARA4W,250,1250,1500
2025-07-23,A00871,BIASHARA6W,56,244,300
2025-07-23,A00872,INUKA 4WKS,0,400,400
2025-07-23,A00882,BIASHARA6W,334,816,1150
2025-07-23,A00892,INUKA6WKS,200,0,200
2025-07-23,A00901,BIASHARA4W,250,750,1000
2025-07-23,A00904,INUKA 4WKS,500,1000,1500
2025-07-23,A00905,BIASHARA4W,250,1250,1500
2025-07-23,A00906,INUKA 4WKS,100,1750,1850
2025-07-23,A00909,BIASHARA6W,334,834,1168
2025-07-23,A00912,INUKA 4WKS,0,900,900
2025-07-23,A00913,BIASHARA4W,250,750,1000
2025-07-23,A00920,INUKA 4WKS,0,250,250
2025-07-23,A00927,INUKA6WKS,165,135,300
2025-07-23,A00931,BIASHARA6W,34,366,400
2025-07-23,A00934,BIASHARA6W,0,100,100
2025-07-23,A00935,BIASHARA6W,334,834,1168
2025-07-23,A00938,BIASHARA4W,0,300,300
2025-07-23,A00939,BIASHARA4W,0,500,500
2025-07-23,A00940,BIASHARA4W,500,2500,3000
2025-07-23,A00941,INUKA 4WKS,0,200,200
2025-07-23,A00942,INUKA 4WKS,500,1650,2150
2025-07-23,A00949,INUKA8WKS,500,500,1000
2025-07-23,A00952,INUKA 4WKS,0,1000,1000
2025-07-23,A00964,INUKA6WKS,500,300,800
2025-07-23,A00977,BIASHARA4W,0,500,500
2025-07-23,A00980,BIASHARA6W,334,834,1168
2025-07-23,A00981,INUKA 4WKS,0,1411,1411
2025-07-23,A00982,BIASHARA4W,250,250,500
2025-07-23,A00983,BIASHARA4W,0,300,300
2025-07-23,A00984,BIASHARA4W,250,1250,1500
2025-07-23,A00985,BIASHARA4W,250,1250,1500
2025-07-23,A00992,INUKA6WKS,500,1150,1650
2025-07-23,A01020,BIASHARA4W,250,50,300
2025-07-23,A01026,BIASHARA4W,0,200,200
2025-07-24,A00097,INUKA6WKS,0,100,100
2025-07-24,A00683,BIASHARA6W,0,64,64
2025-07-24,A00736,INUKA6WKS,0,300,300
2025-07-24,A00750,INUKA8WKS,500,600,1100
2025-07-24,A00766,BIASHARA6W,334,830,1164
2025-07-24,A00769,INUKA6WKS,500,1500,2000
2025-07-24,A00795,BIASHARA6W,333,830,1163
2025-07-24,A00809,BIASHARA6W,334,166,500
2025-07-24,A00828,BIASHARA6W,0,200,200
2025-07-24,A00833,BIASHARA6W,668,1668,2336
2025-07-24,A00882,BIASHARA6W,0,18,18
2025-07-24,A00884,BIASHARA4W,250,1250,1500
2025-07-24,A00888,BIASHARA6W,334,266,600
2025-07-24,A00892,INUKA6WKS,100,100,200
2025-07-24,A00893,BIASHARA6W,0,468,468
2025-07-24,A00894,BIASHARA4W,250,1250,1500
2025-07-24,A00900,INUKA6WKS,34,968,1002
2025-07-24,A00901,BIASHARA4W,0,500,500
2025-07-24,A00907,BIASHARA4W,250,1250,1500
2025-07-24,A00914,INUKA6WKS,492,208,700
2025-07-24,A00929,INUKA 4WKS,500,1750,2250
2025-07-24,A00931,BIASHARA6W,0,300,300
2025-07-24,A00942,INUKA 4WKS,0,100,100
2025-07-24,A00944,INUKA6WKS,500,1334,1834
2025-07-24,A00949,INUKA8WKS,0,250,250
2025-07-24,A00953,BIASHARA4W,250,1250,1500
2025-07-24,A00954,INUKA6WKS,500,1000,1500
2025-07-24,A00959,BIASHARA4W,250,1250,1500
2025-07-24,A00974,INUKA 4WKS,0,350,350
2025-07-24,A00977,BIASHARA4W,0,470,470
2025-07-24,A00982,BIASHARA4W,0,500,500
2025-07-24,A00984,BIASHARA4W,70,0,70
2025-07-24,A00986,INUKA6WKS,500,250,750
2025-07-24,A00987,INUKA8WKS,500,250,750
2025-07-24,A00988,BIASHARA6W,334,416,750
2025-07-24,A00989,INUKA 4WKS,500,1750,2250
2025-07-24,A00990,INUKA 4WKS,500,2000,2500
2025-07-24,A00991,BIASHARA6W,334,834,1168
2025-07-24,A00992,INUKA6WKS,0,17,17
2025-07-24,A00995,INUKA6WKS,500,0,500
2025-07-24,A01006,BIASHARA6W,334,833,1167
2025-07-24,A01020,BIASHARA4W,0,200,200
2025-07-24,A01026,BIASHARA4W,0,200,200
2025-07-25,A00630,INUKA 4WKS,250,250,500
2025-07-25,A00671,BIASHARA6W,334,666,1000
2025-07-25,A00700,BIASHARA6W,150,0,150
2025-07-25,A00708,BIASHARA6W,34,224,258
2025-07-25,A00736,INUKA6WKS,0,298,298
2025-07-25,A00745,INUKA6WKS,497,1103,1600
2025-07-25,A00776,INUKA6WKS,0,350,350
2025-07-25,A00817,INUKA8WKS,500,475,975
2025-07-25,A00818,INUKA6WKS,500,1167,1667
2025-07-25,A00828,BIASHARA6W,8,360,368
2025-07-25,A00878,INUKA6WKS,494,306,800
2025-07-25,A00879,INUKA8WKS,495,580,1075
2025-07-25,A00886,BIASHARA4W,250,1250,1500
2025-07-25,A00888,BIASHARA6W,0,500,500
2025-07-25,A00892,INUKA6WKS,0,200,200
2025-07-25,A00895,BIASHARA4W,250,1250,1500
2025-07-25,A00910,INUKA6WKS,500,1000,1500
2025-07-25,A00911,BIASHARA4W,500,2500,3000
2025-07-25,A00914,INUKA6WKS,41,959,1000
2025-07-25,A00919,BIASHARA6W,0,526,526
2025-07-25,A00927,INUKA6WKS,0,335,335
2025-07-25,A00928,BIASHARA4W,250,1250,1500
2025-07-25,A00931,BIASHARA6W,0,168,168
2025-07-25,A00938,BIASHARA4W,200,0,200
2025-07-25,A00950,INUKA6WKS,500,600,1100
2025-07-25,A00951,INUKA 4WKS,500,1500,2000
2025-07-25,A00958,BIASHARA6W,334,834,1168
2025-07-25,A00964,INUKA6WKS,0,800,800
2025-07-25,A00982,BIASHARA4W,0,500,500
2025-07-25,A00986,INUKA6WKS,0,400,400
2025-07-25,A00987,INUKA8WKS,0,750,750
2025-07-25,A00988,BIASHARA6W,0,418,418
2025-07-25,A00993,INUKA 4WKS,500,1500,2000
2025-07-25,A00994,BIASHARA6W,334,466,800
2025-07-25,A00996,INUKA6WKS,500,1167,1667
2025-07-25,A01006,BIASHARA6W,1,1,2
2025-07-25,A01007,INUKA6WKS,500,1334,1834
2025-07-25,A01008,INUKA6WKS,503,1167,1670
2025-07-25,A01009,INUKA6WKS,500,250,750
2025-07-25,A01020,BIASHARA4W,0,200,200
2025-07-25,A01047,BIASHARA6W,175,0,175
2025-07-26,A00767,BIASHARA6W,334,830,1164
2025-07-26,A00776,INUKA6WKS,0,243,243
2025-07-26,A00809,BIASHARA6W,0,400,400
2025-07-26,A00817,INUKA8WKS,0,200,200
2025-07-26,A00871,BIASHARA6W,100,0,100
2025-07-26,A00878,INUKA6WKS,6,861,867
2025-07-26,A00883,INUKA6WKS,500,1000,1500
2025-07-26,A00888,BIASHARA6W,0,68,68
2025-07-26,A00890,INUKA6WKS,500,1167,1667
2025-07-26,A00892,INUKA6WKS,0,220,220
2025-07-26,A00904,INUKA 4WKS,0,750,750
2025-07-26,A00912,INUKA 4WKS,500,100,600
2025-07-26,A00934,BIASHARA6W,0,100,100
2025-07-26,A00938,BIASHARA4W,50,150,200
2025-07-26,A00950,INUKA6WKS,0,567,567
2025-07-26,A00951,INUKA 4WKS,0,500,500
2025-07-26,A00960,BIASHARA6W,334,466,800
2025-07-26,A00986,INUKA6WKS,51,269,320
2025-07-26,A00995,INUKA6WKS,0,500,500
2025-07-26,A00999,BIASHARA4W,250,1250,1500
2025-07-26,A01020,BIASHARA4W,0,200,200
2025-07-26,A01026,BIASHARA4W,0,200,200
2025-07-26,A01047,BIASHARA6W,100,0,100
2025-07-27,A00733,INUKA6WKS,107,173,280
2025-07-27,A00788,BIASHARA6W,334,830,1164
2025-07-27,A00819,INUKA6WKS,500,1400,1900
2025-07-27,A00862,BIASHARA6W,334,434,768
2025-07-27,A00871,BIASHARA6W,100,0,100
2025-07-27,A00892,INUKA6WKS,0,200,200
2025-07-27,A00896,BIASHARA6W,128,504,632
2025-07-27,A00916,INUKA6WKS,1000,2334,3334
2025-07-27,A00925,INUKA 4WKS,1000,3500,4500
2025-07-27,A00938,BIASHARA4W,0,200,200
2025-07-27,A00941,INUKA 4WKS,500,0,500
2025-07-27,A00946,INUKA 4WKS,500,2500,3000
2025-07-27,A00967,INUKA 4WKS,500,2250,2750
2025-07-27,A00968,INUKA 4WKS,500,1400,1900
2025-07-27,A00995,INUKA6WKS,3,1167,1170
2025-07-27,A01009,INUKA6WKS,0,1030,1030
2025-07-27,A01012,BIASHARA4W,250,1250,1500
2025-07-27,A01013,BIASHARA4W,250,750,1000
2025-07-27,A01015,BIASHARA4W,250,1135,1385
2025-07-27,A01017,INUKA6WKS,500,667,1167
2025-07-27,A01020,BIASHARA4W,0,200,200
2025-07-27,A01021,BIASHARA6W,334,834,1168
2025-07-27,A01026,BIASHARA4W,0,100,100
2025-07-27,A01051,BIASHARA4W,250,1250,1500
2025-07-28,A00657,INUKA8WKS,1500,2800,4300
2025-07-28,A00692,INUKA8WKS,163,137,300
2025-07-28,A00745,INUKA6WKS,500,1214,1714
2025-07-28,A00783,BIASHARA6W,330,830,1160
2025-07-28,A00793,BIASHARA6W,0,828,828
2025-07-28,A00817,INUKA8WKS,0,200,200
2025-07-28,A00819,INUKA6WKS,0,334,334
2025-07-28,A00828,BIASHARA6W,326,74,400
2025-07-28,A00842,BIASHARA6W,668,1664,2332
2025-07-28,A00851,INUKA8WKS,500,750,1250
2025-07-28,A00852,BIASHARA6W,334,834,1168
2025-07-28,A00863,INUKA6WKS,996,3334,4330
2025-07-28,A00868,BIASHARA6W,351,834,1185
2025-07-28,A00879,INUKA8WKS,0,165,165
2025-07-28,A00892,INUKA6WKS,0,425,425
2025-07-28,A00894,BIASHARA4W,50,1250,1300
2025-07-28,A00912,INUKA 4WKS,50,1650,1700
2025-07-28,A00913,BIASHARA4W,0,500,500
2025-07-28,A00915,BIASHARA4W,250,750,1000
2025-07-28,A00917,BIASHARA4W,250,1250,1500
2025-07-28,A00920,INUKA 4WKS,500,1750,2250
2025-07-28,A00931,BIASHARA6W,334,316,650
2025-07-28,A00933,INUKA 4WKS,500,1750,2250
2025-07-28,A00937,BIASHARA6W,334,834,1168
2025-07-28,A00941,INUKA 4WKS,0,100,100
2025-07-28,A00947,BIASHARA6W,334,166,500
2025-07-28,A00963,BIASHARA4W,250,1250,1500
2025-07-28,A00965,BIASHARA6W,334,316,650
2025-07-28,A00966,INUKA8WKS,500,1000,1500
2025-07-28,A00968,INUKA 4WKS,0,350,350
2025-07-28,A00970,INUKA 4WKS,500,500,1000
2025-07-28,A00972,INUKA6WKS,503,1167,1670
2025-07-28,A00973,BIASHARA4W,250,1250,1500
2025-07-28,A00974,INUKA 4WKS,500,500,1000
2025-07-28,A00976,BIASHARA4W,250,1250,1500
2025-07-28,A00978,BIASHARA4W,250,1250,1500
2025-07-28,A00979,INUKA6WKS,500,917,1417
2025-07-28,A00981,INUKA 4WKS,323,0,323
2025-07-28,A01009,INUKA6WKS,6,54,60
2025-07-28,A01013,BIASHARA4W,0,500,500
2025-07-28,A01014,BIASHARA4W,250,1250,1500
2025-07-28,A01015,BIASHARA4W,0,115,115
2025-07-28,A01016,BIASHARA6W,334,834,1168
2025-07-28,A01017,INUKA6WKS,0,1000,1000
2025-07-28,A01019,BIASHARA4W,200,0,200
2025-07-28,A01020,BIASHARA4W,0,400,400
2025-07-28,A01022,BIASHARA6W,334,666,1000
2025-07-28,A01023,BIASHARA4W,250,1250,1500
2025-07-28,A01025,BIASHARA4W,250,1250,1500
2025-07-28,A01026,BIASHARA4W,0,200,200
2025-07-28,A01031,INUKA 4WKS,500,2000,2500
2025-07-29,A00630,INUKA 4WKS,100,0,100
2025-07-29,A00692,INUKA8WKS,37,988,1025
2025-07-29,A00862,BIASHARA6W,0,400,400
2025-07-29,A00871,BIASHARA6W,166,834,1000
2025-07-29,A00875,BIASHARA6W,254,46,300
2025-07-29,A00890,INUKA6WKS,1000,2334,3334
2025-07-29,A00892,INUKA6WKS,0,22,22
2025-07-29,A00893,BIASHARA6W,300,0,300
2025-07-29,A00900,INUKA6WKS,420,0,420
2025-07-29,A00903,BIASHARA4W,250,1250,1500
2025-07-29,A00905,BIASHARA4W,250,1250,1500
2025-07-29,A00908,BIASHARA6W,307,693,1000
2025-07-29,A00915,BIASHARA4W,0,500,500
2025-07-29,A00928,BIASHARA4W,250,750,1000
2025-07-29,A00932,INUKA 4WKS,1000,3500,4500
2025-07-29,A00935,BIASHARA6W,334,834,1168
2025-07-29,A00938,BIASHARA4W,0,200,200
2025-07-29,A00941,INUKA 4WKS,500,3400,3900
2025-07-29,A00943,BIASHARA6W,334,834,1168
2025-07-29,A00947,BIASHARA6W,0,500,500
2025-07-29,A00951,INUKA 4WKS,0,250,250
2025-07-29,A00971,INUKA 4WKS,500,500,1000
2025-07-29,A00974,INUKA 4WKS,0,1250,1250
2025-07-29,A00975,INUKA6WKS,500,1167,1667
2025-07-29,A00977,BIASHARA4W,250,420,670
2025-07-29,A00979,INUKA6WKS,0,250,250
2025-07-29,A00981,INUKA 4WKS,177,1696,1873
2025-07-29,A00983,BIASHARA4W,250,750,1000
2025-07-29,A00994,BIASHARA6W,2,368,370
2025-07-29,A01000,INUKA 4WKS,500,500,1000
2025-07-29,A01019,BIASHARA4W,50,545,595
2025-07-29,A01022,BIASHARA6W,0,168,168
2025-07-29,A01026,BIASHARA4W,0,350,350
2025-07-29,A01027,INUKA 4WKS,500,750,1250
2025-07-29,A01028,INUKA 4WKS,500,1200,1700
2025-07-29,A01029,INUKA6WKS,503,1167,1670
2025-07-29,A01033,INUKA6WKS,500,1500,2000
2025-07-29,A01034,INUKA 4WKS,500,500,1000
2025-07-29,A01037,BIASHARA6W,336,834,1170
2025-07-30,A00402,BIASHARA6W,120,180,300
2025-07-30,A00658,INUKA6WKS,1000,2668,3668
2025-07-30,A00692,INUKA8WKS,300,0,300
2025-07-30,A00745,INUKA6WKS,0,15,15
2025-07-30,A00750,INUKA8WKS,0,300,300
2025-07-30,A00809,BIASHARA6W,2,268,270
2025-07-30,A00818,INUKA6WKS,500,1165,1665
2025-07-30,A00828,BIASHARA6W,0,530,530
2025-07-30,A00865,INUKA8WKS,525,875,1400
2025-07-30,A00878,INUKA6WKS,994,2334,3328
2025-07-30,A00879,INUKA8WKS,10,130,140
2025-07-30,A00882,BIASHARA6W,334,834,1168
2025-07-30,A00893,BIASHARA6W,34,566,600
2025-07-30,A00901,BIASHARA4W,250,1250,1500
2025-07-30,A00902,INUKA6WKS,500,450,950
2025-07-30,A00904,INUKA 4WKS,500,1750,2250
2025-07-30,A00906,INUKA 4WKS,500,800,1300
2025-07-30,A00908,BIASHARA6W,27,141,168
2025-07-30,A00909,BIASHARA6W,200,0,200
2025-07-30,A00910,INUKA6WKS,450,0,450
2025-07-30,A00912,INUKA 4WKS,450,1750,2200
2025-07-30,A00915,BIASHARA4W,250,1250,1500
2025-07-30,A00920,INUKA 4WKS,500,1750,2250
2025-07-30,A00927,INUKA6WKS,0,400,400
2025-07-30,A00928,BIASHARA4W,0,500,500
2025-07-30,A00929,INUKA 4WKS,500,800,1300
2025-07-30,A00938,BIASHARA4W,250,1950,2200
2025-07-30,A00939,BIASHARA4W,500,2500,3000
2025-07-30,A00942,INUKA 4WKS,500,1750,2250
2025-07-30,A00944,INUKA6WKS,500,150,650
2025-07-30,A00960,BIASHARA6W,0,350,350
2025-07-30,A00965,BIASHARA6W,0,300,300
2025-07-30,A00971,INUKA 4WKS,0,500,500
2025-07-30,A00980,BIASHARA6W,334,834,1168
2025-07-30,A00981,INUKA 4WKS,11,54,65
2025-07-30,A00982,BIASHARA4W,250,750,1000
2025-07-30,A00983,BIASHARA4W,0,500,500
2025-07-30,A00985,BIASHARA4W,250,1250,1500
2025-07-30,A01018,BIASHARA6W,336,834,1170
2025-07-30,A01019,BIASHARA4W,0,450,450
2025-07-30,A01020,BIASHARA4W,250,150,400
2025-07-30,A01026,BIASHARA4W,200,0,200
2025-07-30,A01027,INUKA 4WKS,0,1000,1000
2025-07-30,A01028,INUKA 4WKS,0,1000,1000
2025-07-30,A01034,INUKA 4WKS,0,850,850
2025-07-30,A01039,INUKA 4WKS,500,650,1150
2025-07-30,A01040,BIASHARA4W,250,1250,1500
2025-07-30,A01041,INUKA6WKS,503,1167,1670
2025-07-30,A01043,BIASHARA4W,250,1250,1500
2025-07-30,A01052,BIASHARA4W,250,1250,1500
2025-07-31,A00552,BIASHARA6W,1002,3288,4290
2025-07-31,A00630,INUKA 4WKS,150,1350,1500
2025-07-31,A00671,BIASHARA6W,0,190,190
2025-07-31,A00676,INUKA6WKS,500,2081,2581
2025-07-31,A00708,BIASHARA6W,0,606,606
2025-07-31,A00750,INUKA8WKS,125,225,350
2025-07-31,A00805,INUKA 4WKS,500,2500,3000
2025-07-31,A00833,BIASHARA6W,334,830,1164
2025-07-31,A00871,BIASHARA6W,246,154,400
2025-07-31,A00875,BIASHARA6W,212,788,1000
2025-07-31,A00892,INUKA6WKS,300,0,300
2025-07-31,A00893,BIASHARA6W,0,268,268
2025-07-31,A00900,INUKA6WKS,546,2334,2880
2025-07-31,A00906,INUKA 4WKS,0,950,950
2025-07-31,A00907,BIASHARA4W,250,1250,1500
2025-07-31,A00909,BIASHARA6W,134,834,968
2025-07-31,A00910,INUKA6WKS,50,1000,1050
2025-07-31,A00914,INUKA6WKS,459,291,750
2025-07-31,A00927,INUKA6WKS,0,267,267
2025-07-31,A00929,INUKA 4WKS,50,950,1000
2025-07-31,A00934,BIASHARA6W,0,150,150
2025-07-31,A00944,INUKA6WKS,0,700,700
2025-07-31,A00948,INUKA6WKS,503,1667,2170
2025-07-31,A00953,BIASHARA4W,250,850,1100
2025-07-31,A00970,INUKA 4WKS,0,1250,1250
2025-07-31,A00971,INUKA 4WKS,0,500,500
2025-07-31,A00974,INUKA 4WKS,1000,3500,4500
2025-07-31,A00977,BIASHARA4W,0,830,830
2025-07-31,A00978,BIASHARA4W,500,2500,3000
2025-07-31,A00982,BIASHARA4W,0,500,500
2025-07-31,A00984,BIASHARA4W,180,950,1130
2025-07-31,A00986,INUKA6WKS,449,551,1000
2025-07-31,A00987,INUKA8WKS,500,250,750
2025-07-31,A00988,BIASHARA6W,334,266,600
2025-07-31,A00989,INUKA 4WKS,500,1750,2250
2025-07-31,A00991,BIASHARA6W,334,834,1168
2025-07-31,A00992,INUKA6WKS,503,1167,1670
2025-07-31,A00994,BIASHARA6W,336,834,1170
2025-07-31,A00996,INUKA6WKS,533,1167,1700
2025-07-31,A01000,INUKA 4WKS,0,1000,1000
2025-07-31,A01006,BIASHARA6W,334,834,1168
2025-07-31,A01019,BIASHARA4W,0,200,200
2025-07-31,A01026,BIASHARA4W,50,150,200
2025-07-31,A01028,INUKA 4WKS,0,50,50
2025-07-31,A01034,INUKA 4WKS,0,400,400
2025-07-31,A01039,INUKA 4WKS,0,1100,1100
2025-07-31,A01042,BIASHARA4W,250,750,1000
2025-07-31,A01045,INUKA6WKS,516,1334,1850
2025-07-31,A01046,BIASHARA6W,334,834,1168
2025-07-31,A01047,BIASHARA6W,59,201,260
2025-07-31,A01048,BIASHARA6W,334,834,1168
2025-07-31,A01054,BIASHARA4W,250,1250,1500
2025-07-31,A01055,BIASHARA4W,250,1250,1500
2025-07-31,A01057,BIASHARA4W,250,1250,1500
2025-07-31,A01083,BIASHARA6W,200,0,200
2025-07-31,A01086,BIASHARA4W,250,0,250
2025-08-01,A00401,INUKA6WKS,250,0,250
2025-08-01,A00692,INUKA8WKS,163,87,250
2025-08-01,A00805,INUKA 4WKS,500,1500,2000
2025-08-01,A00828,BIASHARA6W,668,1898,2566
2025-08-01,A00871,BIASHARA6W,0,676,676
2025-08-01,A00888,BIASHARA6W,334,366,700
2025-08-01,A00892,INUKA6WKS,200,100,300
2025-08-01,A00914,INUKA6WKS,41,876,917
2025-08-01,A00916,INUKA6WKS,500,1167,1667
2025-08-01,A00931,BIASHARA6W,0,200,200
2025-08-01,A00942,INUKA 4WKS,500,1750,2250
2025-08-01,A00946,INUKA 4WKS,500,2500,3000
2025-08-01,A00950,INUKA6WKS,500,500,1000
2025-08-01,A00951,INUKA 4WKS,500,2250,2750
2025-08-01,A00953,BIASHARA4W,0,400,400
2025-08-01,A00954,INUKA6WKS,500,1000,1500
2025-08-01,A00959,BIASHARA4W,250,1250,1500
2025-08-01,A00965,BIASHARA6W,0,150,150
2025-08-01,A00971,INUKA 4WKS,0,500,500
2025-08-01,A00984,BIASHARA4W,0,300,300
2025-08-01,A00990,INUKA 4WKS,500,2000,2500
2025-08-01,A00993,INUKA 4WKS,500,1100,1600
2025-08-01,A00995,INUKA6WKS,503,1667,2170
2025-08-01,A01007,INUKA6WKS,500,1334,1834
2025-08-01,A01009,INUKA6WKS,494,6,500
2025-08-01,A01019,BIASHARA4W,0,55,55
2025-08-01,A01020,BIASHARA4W,0,150,150
2025-08-01,A01032,BIASHARA6W,334,834,1168
2025-08-01,A01047,BIASHARA6W,10,633,643
2025-08-01,A01053,BIASHARA4W,250,750,1000
2025-08-01,A01058,BIASHARA4W,500,2300,2800
2025-08-01,A01062,INUKA 4WKS,500,700,1200
2025-08-01,A01063,INUKA 4WKS,500,1750,2250
2025-08-01,A01064,BIASHARA6W,334,834,1168
2025-08-01,A01100,INUKA 4WKS,150,0,150
2025-08-02,A00657,INUKA8WKS,0,200,200
2025-08-02,A00692,INUKA8WKS,0,300,300
2025-08-02,A00733,INUKA6WKS,0,100,100
2025-08-02,A00817,INUKA8WKS,500,875,1375
2025-08-02,A00879,INUKA8WKS,490,370,860
2025-08-02,A00883,INUKA6WKS,500,1000,1500
2025-08-02,A00888,BIASHARA6W,0,468,468
2025-08-02,A00892,INUKA6WKS,0,300,300
2025-08-02,A00902,INUKA6WKS,0,550,550
2025-08-02,A00919,BIASHARA6W,334,666,1000
2025-08-02,A00927,INUKA6WKS,470,30,500
2025-08-02,A00950,INUKA6WKS,3,667,670
2025-08-02,A00958,BIASHARA6W,302,198,500
2025-08-02,A00964,INUKA6WKS,500,300,800
2025-08-02,A00965,BIASHARA6W,32,68,100
2025-08-02,A00987,INUKA8WKS,0,750,750
2025-08-02,A00999,BIASHARA4W,250,1250,1500
2025-08-02,A01008,INUKA6WKS,503,1167,1670
2025-08-02,A01020,BIASHARA4W,0,200,200
2025-08-02,A01026,BIASHARA4W,0,200,200
2025-08-02,A01053,BIASHARA4W,0,500,500
2025-08-02,A01086,BIASHARA4W,0,250,250
2025-08-02,A01100,INUKA 4WKS,100,0,100
2025-08-03,A00402,BIASHARA6W,0,400,400
2025-08-03,A00692,INUKA8WKS,0,300,300
2025-08-03,A00809,BIASHARA6W,332,68,400
2025-08-03,A00892,INUKA6WKS,0,300,300
2025-08-03,A00903,BIASHARA4W,250,1250,1500
2025-08-03,A00931,BIASHARA6W,0,300,300
2025-08-03,A00934,BIASHARA6W,153,147,300
2025-08-03,A00988,BIASHARA6W,32,568,600
2025-08-03,A00993,INUKA 4WKS,0,300,300
2025-08-03,A01009,INUKA6WKS,0,700,700
2025-08-03,A01012,BIASHARA4W,250,1250,1500
2025-08-03,A01015,BIASHARA4W,250,1250,1500
2025-08-03,A01020,BIASHARA4W,0,400,400
2025-08-03,A01023,BIASHARA4W,250,1250,1500
2025-08-03,A01026,BIASHARA4W,0,200,200
2025-08-03,A01042,BIASHARA4W,0,500,500
2025-08-03,A01077,BIASHARA4W,250,1250,1500
2025-08-03,A01078,BIASHARA4W,250,1250,1500
2025-08-03,A01086,BIASHARA4W,0,250,250
2025-08-03,A01087,INUKA6WKS,500,1167,1667
2025-08-04,A00402,BIASHARA6W,0,250,250
2025-08-04,A00535,INUKA6WKS,100,0,100
2025-08-04,A00671,BIASHARA6W,0,150,150
2025-08-04,A00692,INUKA8WKS,37,438,475
2025-08-04,A00769,INUKA6WKS,0,110,110
2025-08-04,A00851,INUKA8WKS,500,750,1250
2025-08-04,A00852,BIASHARA6W,334,830,1164
2025-08-04,A00862,BIASHARA6W,334,266,600
2025-08-04,A00868,BIASHARA6W,317,683,1000
2025-08-04,A00879,INUKA8WKS,0,300,300
2025-08-04,A00892,INUKA6WKS,0,467,467
2025-08-04,A00893,BIASHARA6W,300,0,300
2025-08-04,A00896,BIASHARA6W,206,344,550
2025-08-04,A00908,BIASHARA6W,334,834,1168
2025-08-04,A00919,BIASHARA6W,0,170,170
2025-08-04,A00928,BIASHARA4W,250,1250,1500
2025-08-04,A00931,BIASHARA6W,0,18,18
2025-08-04,A00933,INUKA 4WKS,500,1750,2250
2025-08-04,A00934,BIASHARA6W,150,0,150
2025-08-04,A00935,BIASHARA6W,334,834,1168
2025-08-04,A00944,INUKA6WKS,0,482,482
2025-08-04,A00951,INUKA 4WKS,500,2250,2750
2025-08-04,A00957,BIASHARA4W,0,500,500
2025-08-04,A00958,BIASHARA6W,0,401,401
2025-08-04,A00963,BIASHARA4W,250,1250,1500
2025-08-04,A00964,INUKA6WKS,0,867,867
2025-08-04,A00965,BIASHARA6W,302,98,400
2025-08-04,A00966,INUKA8WKS,500,1000,1500
2025-08-04,A00967,INUKA 4WKS,500,2250,2750
2025-08-04,A00968,INUKA 4WKS,1000,3500,4500
2025-08-04,A00971,INUKA 4WKS,500,500,1000
2025-08-04,A00973,BIASHARA4W,250,1250,1500
2025-08-04,A00976,BIASHARA4W,250,750,1000
2025-08-04,A00979,INUKA6WKS,500,899,1399
2025-08-04,A00981,INUKA 4WKS,489,510,999
2025-08-04,A00989,INUKA 4WKS,1000,3500,4500
2025-08-04,A00993,INUKA 4WKS,0,100,100
2025-08-04,A01009,INUKA6WKS,0,628,628
2025-08-04,A01013,BIASHARA4W,250,1250,1500
2025-08-04,A01014,BIASHARA4W,250,350,600
2025-08-04,A01016,BIASHARA6W,334,834,1168
2025-08-04,A01017,INUKA6WKS,500,500,1000
2025-08-04,A01019,BIASHARA4W,250,850,1100
2025-08-04,A01020,BIASHARA4W,0,200,200
2025-08-04,A01021,BIASHARA6W,334,834,1168
2025-08-04,A01022,BIASHARA6W,334,61,395
2025-08-04,A01025,BIASHARA4W,250,1250,1500
2025-08-04,A01026,BIASHARA4W,0,250,250
2025-08-04,A01027,INUKA 4WKS,500,50,550
2025-08-04,A01028,INUKA 4WKS,1500,6750,8250
2025-08-04,A01029,INUKA6WKS,497,1167,1664
2025-08-04,A01031,INUKA 4WKS,500,2000,2500
2025-08-04,A01062,INUKA 4WKS,0,1050,1050
2025-08-04,A01065,INUKA 4WKS,500,1750,2250
2025-08-04,A01068,BIASHARA4W,250,1250,1500
2025-08-04,A01069,BIASHARA6W,334,834,1168
2025-08-04,A01070,BIASHARA6W,334,656,990
2025-08-04,A01071,INUKA 4WKS,500,2000,2500
2025-08-04,A01072,INUKA6WKS,523,1167,1690
2025-08-04,A01073,BIASHARA4W,250,1250,1500
2025-08-04,A01079,BIASHARA6W,336,834,1170
2025-08-04,A01081,INUKA 4WKS,500,1750,2250
2025-08-04,A01086,BIASHARA4W,0,250,250
2025-08-04,A01100,INUKA 4WKS,200,0,200
2025-08-05,A00692,INUKA8WKS,463,1125,1588
2025-08-05,A00819,INUKA6WKS,500,800,1300
2025-08-05,A00862,BIASHARA6W,0,564,564
2025-08-05,A00875,BIASHARA6W,122,830,952
2025-08-05,A00879,INUKA8WKS,5,205,210
2025-08-05,A00909,BIASHARA6W,668,1668,2336
2025-08-05,A00943,BIASHARA6W,334,834,1168
2025-08-05,A00957,BIASHARA4W,250,750,1000
2025-08-05,A00958,BIASHARA6W,25,235,260
2025-08-05,A00960,BIASHARA6W,334,166,500
2025-08-05,A00963,BIASHARA4W,250,1250,1500
2025-08-05,A00971,INUKA 4WKS,0,1000,1000
2025-08-05,A00973,BIASHARA4W,250,1250,1500
2025-08-05,A00975,INUKA6WKS,500,1167,1667
2025-08-05,A00976,BIASHARA4W,0,500,500
2025-08-05,A00979,INUKA6WKS,0,268,268
2025-08-05,A00980,BIASHARA6W,334,166,500
2025-08-05,A00981,INUKA 4WKS,40,1240,1280
2025-08-05,A00983,BIASHARA4W,500,2500,3000
2025-08-05,A00984,BIASHARA4W,250,250,500
2025-08-05,A00986,INUKA6WKS,517,1783,2300
2025-08-05,A01014,BIASHARA4W,0,900,900
2025-08-05,A01018,BIASHARA6W,334,834,1168
2025-08-05,A01020,BIASHARA4W,50,150,200
2025-08-05,A01026,BIASHARA4W,0,200,200
2025-08-05,A01032,BIASHARA6W,334,66,400
2025-08-05,A01033,INUKA6WKS,500,1500,2000
2025-08-05,A01037,BIASHARA6W,336,834,1170
2025-08-05,A01039,INUKA 4WKS,500,750,1250
2025-08-05,A01057,BIASHARA4W,250,750,1000
2025-08-05,A01066,INUKA6WKS,500,1667,2167
2025-08-05,A01070,BIASHARA6W,0,178,178
2025-08-05,A01080,BIASHARA4W,250,1250,1500
2025-08-05,A01082,INUKA8WKS,500,1125,1625
2025-08-05,A01083,BIASHARA6W,134,670,804
2025-08-05,A01084,INUKA 4WKS,500,1750,2250
2025-08-05,A01086,BIASHARA4W,0,250,250
2025-08-05,A01088,BIASHARA4W,250,250,500
2025-08-05,A01090,BIASHARA4W,250,1250,1500
2025-08-05,A01100,INUKA 4WKS,50,240,290
2025-08-05,A01105,INUKA6WKS,500,200,700
2025-08-06,A00671,BIASHARA6W,0,200,200
2025-08-06,A00749,BIASHARA4W,0,100,100
2025-08-06,A00819,INUKA6WKS,0,667,667
2025-08-06,A00851,INUKA8WKS,1000,1500,2500
2025-08-06,A00868,BIASHARA6W,17,151,168
2025-08-06,A00882,BIASHARA6W,334,830,1164
2025-08-06,A00883,INUKA6WKS,500,1000,1500
2025-08-06,A00892,INUKA6WKS,200,0,200
2025-08-06,A00893,BIASHARA6W,34,466,500
2025-08-06,A00896,BIASHARA6W,0,200,200
2025-08-06,A00931,BIASHARA6W,300,0,300
2025-08-06,A00944,INUKA6WKS,500,200,700
2025-08-06,A00946,INUKA 4WKS,500,2500,3000
2025-08-06,A00953,BIASHARA4W,250,1250,1500
2025-08-06,A00957,BIASHARA4W,0,500,500
2025-08-06,A00964,INUKA6WKS,500,234,734
2025-08-06,A00965,BIASHARA6W,0,400,400
2025-08-06,A00971,INUKA 4WKS,0,500,500
2025-08-06,A00972,INUKA6WKS,503,1167,1670
2025-08-06,A00977,BIASHARA4W,250,390,640
2025-08-06,A00980,BIASHARA6W,0,668,668
2025-08-06,A00981,INUKA 4WKS,460,1750,2210
2025-08-06,A00982,BIASHARA4W,250,1250,1500
2025-08-06,A00985,BIASHARA4W,500,2500,3000
2025-08-06,A00988,BIASHARA6W,302,198,500
2025-08-06,A00992,INUKA6WKS,497,1113,1610
2025-08-06,A01017,INUKA6WKS,0,1167,1167
2025-08-06,A01019,BIASHARA4W,0,400,400
2025-08-06,A01022,BIASHARA6W,0,773,773
2025-08-06,A01026,BIASHARA4W,0,250,250
2025-08-06,A01027,INUKA 4WKS,0,1350,1350
2025-08-06,A01034,INUKA 4WKS,500,750,1250
2025-08-06,A01040,BIASHARA4W,250,600,850
2025-08-06,A01041,INUKA6WKS,503,1167,1670
2025-08-06,A01042,BIASHARA4W,250,250,500
2025-08-06,A01043,BIASHARA4W,250,1250,1500
2025-08-06,A01047,BIASHARA6W,334,834,1168
2025-08-06,A01051,BIASHARA4W,250,750,1000
2025-08-06,A01052,BIASHARA4W,250,1250,1500
2025-08-06,A01067,INUKA6WKS,500,1500,2000
2025-08-06,A01084,INUKA 4WKS,0,250,250
2025-08-06,A01085,INUKA6WKS,500,1000,1500
2025-08-06,A01086,BIASHARA4W,0,250,250
2025-08-06,A01088,BIASHARA4W,0,1000,1000
2025-08-06,A01089,INUKA 4WKS,500,750,1250
2025-08-06,A01091,INUKA8WKS,375,0,375
2025-08-06,A01093,INUKA6WKS,500,1167,1667
2025-08-06,A01094,BIASHARA4W,250,50,300
2025-08-06,A01096,INUKA 4WKS,500,1750,2250
2025-08-06,A01100,INUKA 4WKS,0,830,830
2025-08-06,A01103,BIASHARA6W,334,834,1168
2025-08-06,A01105,INUKA6WKS,0,700,700
2025-08-06,A01111,BIASHARA4W,250,150,400
2025-08-07,A00401,INUKA6WKS,17,183,200
2025-08-07,A00868,BIASHARA6W,160,0,160
2025-08-07,A00892,INUKA6WKS,300,0,300
2025-08-07,A00896,BIASHARA6W,110,290,400
2025-08-07,A00914,INUKA6WKS,459,41,500
2025-08-07,A00934,BIASHARA6W,31,69,100
2025-08-07,A00944,INUKA6WKS,0,1136,1136
2025-08-07,A00957,BIASHARA4W,250,750,1000
2025-08-07,A00965,BIASHARA6W,14,336,350
2025-08-07,A00977,BIASHARA4W,0,400,400
2025-08-07,A00984,BIASHARA4W,0,1000,1000
2025-08-07,A00987,INUKA8WKS,500,1000,1500
2025-08-07,A00988,BIASHARA6W,4,636,640
2025-08-07,A00990,INUKA 4WKS,500,0,500
2025-08-07,A00991,BIASHARA6W,334,834,1168
2025-08-07,A00992,INUKA6WKS,6,54,60
2025-08-07,A00995,INUKA6WKS,494,6,500
2025-08-07,A00996,INUKA6WKS,467,1133,1600
2025-08-07,A01006,BIASHARA6W,333,767,1100
2025-08-07,A01026,BIASHARA4W,100,0,100
2025-08-07,A01027,INUKA 4WKS,0,350,350
2025-08-07,A01032,BIASHARA6W,2,768,770
2025-08-07,A01034,INUKA 4WKS,0,510,510
2025-08-07,A01040,BIASHARA4W,0,650,650
2025-08-07,A01042,BIASHARA4W,0,600,600
2025-08-07,A01045,INUKA6WKS,516,1334,1850
2025-08-07,A01048,BIASHARA6W,334,834,1168
2025-08-07,A01051,BIASHARA4W,0,500,500
2025-08-07,A01055,BIASHARA4W,250,1250,1500
2025-08-07,A01057,BIASHARA4W,0,500,500
2025-08-07,A01058,BIASHARA4W,250,1250,1500
2025-08-07,A01063,INUKA 4WKS,500,1250,1750
2025-08-07,A01089,INUKA 4WKS,0,1000,1000
2025-08-07,A01095,BIASHARA4W,250,950,1200
2025-08-07,A01097,BIASHARA4W,250,750,1000
2025-08-07,A01098,INUKA 4WKS,500,2500,3000
2025-08-07,A01100,INUKA 4WKS,0,930,930
2025-08-07,A01105,INUKA6WKS,233,267,500
2025-08-08,A00535,INUKA6WKS,85,15,100
2025-08-08,A00817,INUKA8WKS,1000,1750,2750
2025-08-08,A00865,INUKA8WKS,1375,2625,4000
2025-08-08,A00868,BIASHARA6W,157,830,987
2025-08-08,A00888,BIASHARA6W,334,366,700
2025-08-08,A00892,INUKA6WKS,0,300,300
2025-08-08,A00893,BIASHARA6W,0,100,100
2025-08-08,A00902,INUKA6WKS,500,1000,1500
2025-08-08,A00910,INUKA6WKS,500,500,1000
2025-08-08,A00914,INUKA6WKS,64,1126,1190
2025-08-08,A00919,BIASHARA6W,334,834,1168
2025-08-08,A00927,INUKA6WKS,31,1167,1198
2025-08-08,A00929,INUKA 4WKS,450,550,1000
2025-08-08,A00947,BIASHARA6W,0,168,168
2025-08-08,A00948,INUKA6WKS,503,1667,2170
2025-08-08,A00954,INUKA6WKS,500,1000,1500
2025-08-08,A00957,BIASHARA4W,0,1000,1000
2025-08-08,A00958,BIASHARA6W,300,0,300
2025-08-08,A00959,BIASHARA4W,250,1250,1500
2025-08-08,A00970,INUKA 4WKS,510,1750,2260
2025-08-08,A00977,BIASHARA4W,0,390,390
2025-08-08,A00994,BIASHARA6W,336,834,1170
2025-08-08,A00995,INUKA6WKS,0,500,500
2025-08-08,A00996,INUKA6WKS,66,34,100
2025-08-08,A00999,BIASHARA4W,250,800,1050
2025-08-08,A01006,BIASHARA6W,1,67,68
2025-08-08,A01009,INUKA6WKS,500,0,500
2025-08-08,A01020,BIASHARA4W,200,100,300
2025-08-08,A01034,INUKA 4WKS,0,490,490
2025-08-08,A01046,BIASHARA6W,334,834,1168
2025-08-08,A01053,BIASHARA4W,250,750,1000
2025-08-08,A01054,BIASHARA4W,250,1250,1500
2025-08-08,A01063,INUKA 4WKS,0,500,500
2025-08-08,A01064,BIASHARA6W,334,834,1168
2025-08-08,A01083,BIASHARA6W,0,100,100
2025-08-08,A01086,BIASHARA4W,250,0,250
2025-08-08,A01094,BIASHARA4W,0,300,300
2025-08-08,A01095,BIASHARA4W,0,300,300
2025-08-08,A01097,BIASHARA4W,0,500,500
2025-08-08,A01101,BIASHARA4W,250,1250,1500
2025-08-08,A01104,BIASHARA6W,334,516,850
2025-08-09,A00879,INUKA8WKS,495,155,650
2025-08-09,A00888,BIASHARA6W,0,464,464
2025-08-09,A00892,INUKA6WKS,0,300,300
2025-08-09,A00893,BIASHARA6W,0,150,150
2025-08-09,A00937,BIASHARA6W,334,166,500
2025-08-09,A00947,BIASHARA6W,334,166,500
2025-08-09,A00950,INUKA6WKS,497,1053,1550
2025-08-09,A00979,INUKA6WKS,500,200,700
2025-08-09,A00990,INUKA 4WKS,0,1000,1000
2025-08-09,A00993,INUKA 4WKS,500,1500,2000
2025-08-09,A00995,INUKA6WKS,9,1161,1170
2025-08-09,A00999,BIASHARA4W,0,100,100
2025-08-09,A01047,BIASHARA6W,210,0,210
2025-08-09,A01065,INUKA 4WKS,500,1750,2250
2025-08-09,A01068,BIASHARA4W,250,1050,1300
2025-08-09,A01083,BIASHARA6W,6,64,70
2025-08-09,A01086,BIASHARA4W,0,250,250
2025-08-09,A01094,BIASHARA4W,0,900,900
2025-08-09,A01102,INUKA 4WKS,500,2150,2650
2025-08-09,A01104,BIASHARA6W,0,318,318
2025-08-09,A01141,BIASHARA6W,170,0,170
2025-08-10,A00892,INUKA6WKS,0,200,200
2025-08-10,A00934,BIASHARA6W,0,200,200
2025-08-10,A00947,BIASHARA6W,0,500,500
2025-08-10,A00957,BIASHARA4W,250,250,500
2025-08-10,A00967,INUKA 4WKS,500,2250,2750
2025-08-10,A00977,BIASHARA4W,0,70,70
2025-08-10,A00999,BIASHARA4W,20,350,370
2025-08-10,A01009,INUKA6WKS,0,500,500
2025-08-10,A01012,BIASHARA4W,250,1250,1500
2025-08-10,A01014,BIASHARA4W,250,1250,1500
2025-08-10,A01015,BIASHARA4W,500,2440,2940
2025-08-10,A01042,BIASHARA4W,0,400,400
2025-08-10,A01068,BIASHARA4W,0,200,200
2025-08-10,A01078,BIASHARA4W,250,250,500
2025-08-10,A01105,INUKA6WKS,267,233,500
2025-08-10,A01111,BIASHARA4W,0,700,700
2025-08-11,A00896,BIASHARA6W,224,326,550
2025-08-11,A00935,BIASHARA6W,334,830,1164
2025-08-11,A00937,BIASHARA6W,0,668,668
2025-08-11,A00950,INUKA6WKS,6,114,120
2025-08-11,A01015,BIASHARA4W,0,60,60
2025-08-11,A01020,BIASHARA4W,0,200,200
2025-08-11,A01025,BIASHARA4W,250,1250,1500
2025-08-11,A01026,BIASHARA4W,150,50,200
2025-08-11,A01106,INUKA6WKS,500,1500,2000
2025-08-11,A01107,BIASHARA4W,250,1150,1400
2025-08-11,A01111,BIASHARA4W,0,400,400
